# Baby names
അകര്ശാനാ	అకర్శానా
അക്ശൈനീഏ	అక్శైనీఏ
അഗജാ	అగజా
അചിംത	అచింత
അചിത	అచిత
അച്ചിന്ദ്ര	అచ్చిన్ద్ర
അഡ്യാദവൈതാ	అడ్యాదవైతా
അദഭുതഃ	అదభుతః
അദേന്യ	అదేన్య
അദേല	అదేల
അദ്രിതീ	అద్రితీ
അദ്രീഥീ	అద్రీథీ
അദ്രീമാം	అద్రీమాం
അദ്വൈയാ	అద్వైయా
അധര്ഷ	అధర్ష
അധിപാ	అధిపా
അധീരതാ	అధీరతా
അധ്യുത	అధ్యుత
അനംതാമായാ	అనంతామాయా
അബരനാ	అబరనా
അബിനയ	అబినయ
അബിനാ	అబినా
അബീനംദാ	అబీనందా
അബീശാ	అబీశా
അഭയ	అభయ
അഭയന	అభయన
അഭിഗ്ന്യാ	అభిగ్న్యా
അഭിജീതാ	అభిజీతా
അഭിനിവേശ	అభినివేశ
അഭിമ	అభిమ
അഭിമാനീ	అభిమానీ
അഭിമോദാ	అభిమేాదా
അഭിരാ	అభిరా
അഭിരാത	అభిరాత
അഭീരല	అభీరల
അഭീശ്രേയ	అభీశ్రేయ
അഭീസുമത	అభీసుమత
അഭ്യപ്സീത	అభ్యప్సీత
അഭ്യുദയാ	అభ్యుదయా
അമൃതാ	అమృతా
അലകനംദാ	అలకనందా
അലക്ഷാ	అలక్షా
അല്കാ	అల్కా
അശവ	అశవ
അശ്നേഇല	అశ్నేఇల
ആകാശലീനാ	ఆకాశలీనా
ആകൃഥീ	ఆకృథీ
ആക്ഷ്യാ	ఆక్ష్యా
ആചാര്യ	ఆచార్య
ആത്മയ	ఆత్మయ
ആദി	ఆది
ആദിമ	ఆదిమ
ആദീവ	ఆదీవ
ആധീരേന	ఆధీరేన
ആധ്യാ	ఆధ్యా
ആനംദീനീ	ఆనందీనీ
ആനീകാ	ఆనీకా
ആന്തീകാ	ఆన్తీకా
ആന്വീ	ఆన్వీ
ആപ്ത	ఆప్త
ആപ്തി	ఆప్తి
ആമാംനീ	ఆమాంనీ
ആമിഷ	ఆమిష
ആമുക്ഥാ	ఆముక్థా
ആയുസ	ఆయుస
ആയോദ	ఆయేాద
ആരംഭീ	ఆరంభీ
ആരതീ	ఆరతీ
ആരസീ	ఆరసీ
ആര്യ	ఆర్య
ആര്യക	ఆర్యక
ആര്യനാ	ఆర్యనా
ആര്യമാനീ	ఆర్యమానీ
ആലേഃയാ	ఆలేఃయా
ആവംശ	ఆవంశ
ആവേശ	ఆవేశ
ആശകാ	ఆశకా
ആശിയാനാ	ఆశియానా
ആശുതോഷ	ఆశుతేాష
ആശ്മീന	ఆశ్మీన
ആശ്വിത	ఆశ్విత
ആസവ	ఆసవ
ആസ്തിക	ఆస్తిక
ഇക്ശാനാ	ఇక్శానా
ഇജയാ	ఇజయా
ഇനീയന	ఇనీయన
ഇനോദയ	ఇనేాదయ
ഇന്ദരകാന്ത	ఇన్దరకాన్త
ഇന്ദിവാരസ	ఇన్దివారస
ഇന്ദുശിതാലാ	ఇన్దుశితాలా
ഇന്ദ്രജാ	ఇన్ద్రజా
ഇന്ദ്രതന	ఇన్ద్రతన
ഇന്ദ്രദയുമ്ന	ఇన్ద్రదయుమ్న
ഇന്ദ്രവദന	ఇన్ద్రవదన
ഇന്ദ്രാണീ	ఇన్ద్రాణీ
ഇബ്ബാനീ	ఇబ్బానీ
ഇയുരേശ	ఇయురేశ
ഇയേനഗര	ఇయేనగర
ഇരാജ	ఇరాజ
ഇരിത	ఇరిత
ഇരേശ	ఇరేశ
ഇലിസാ	ఇలిసా
ഇശിതാ	ఇశితా
ഇശ്വാര്യ	ఇశ్వార్య
ഇഷ്ടാ	ఇష్టా
ഇഷ്ടി	ఇష్టి
ഇസാര	ఇసార
ഇസ്ശും	ఇస్శుం
ഈതന	ఈతన
ഈതികാ	ఈతికా
ഈരേന്പ്രിത	ఈరేన్ప్రిత
ഈര്ശീതാ	ఈర్శీతా
ഈലാക്കീയാ	ఈలాక్కీయా
ഈലികാ	ఈలికా
ഈലേശാ	ఈలేశా
ഈശാര	ఈశార
ഈശിക	ఈశిక
ഈശ്വരദത്ത	ఈశ్వరదత్త
ഈഹാ	ఈహా
ഉഗ്രസ്രവാസ	ఉగ్రస్రవాస
ഉജവണീ	ఉజవణీ
ഉജേശാ	ఉజేశా
ഉജ്ജന	ఉజ్జన
ഉജ്ജവല	ఉజ్జవల
ഉജ്ജവാലാ	ఉజ్జవాలా
ഉജ്ജ്വലാ /ഉജ്വലാ	ఉజ్జ్వలా /ఉజ్వలా
ഉജ്ജ്വാലാ	ఉజ్జ్వాలా
ഉത്കര്ഷ	ఉత్కర్ష
ഉത്കലാ	ఉత్కలా
ഉത്തര	ఉత్తర
ഉത്പര	ఉత్పర
ഉത്സര്ഗ	ఉత్సర్గ
ഉദയ കുമാര	ఉదయ కుమార
ഉദരഥീ	ఉదరథీ
ഉദാന്തികാ	ఉదాన్తికా
ഉദേയ	ఉదేయ
ഉദ്ധാര	ఉద్ధార
ഉദ്യത	ఉద్యత
ഉദ്യമീ	ఉద్యమీ
ഉദ്യോത	ఉద్యేాత
ഉധവ	ఉధవ
ഉപംഗ	ఉపంగ
ഉപദാ	ఉపదా
ഉപാധ്രീതീ	ఉపాధ్రీతీ
ഉപ്പാസ	ఉప్పాస
ഉമാ	ఉమా
ഉമേശ്വര	ఉమేశ్వర
ഉരിശിതാ	ఉరిశితా
ഉര്ജാ	ఉర్జా
ഉര്ജീകാ	ఉర్జీకా
ഉര്ജീതാ	ఉర్జీతా
ഉര്ദാഹാവ	ఉర్దాహావ
ഉര്മികാ	ఉర్మికా
ഉര്മിമാലാ	ఉర్మిమాలా
ഉര്വീനാഥ	ఉర్వీనాథ
ഉല്പേശ	ఉల్పేశ
ഉശേന്യ	ఉశేన్య
ഉഷാശി	ఉషాశి
ഉഷ്മാ	ఉష్మా
ഉസരീ	ఉసరీ
ഊതരാ	ఊతరా
ഊര്വേശ	ఊర్వేశ
ഏകംശീ	ఏకంశీ
ഏകക്ഷരപരാ	ఏకక్షరపరా
ഏകതന	ఏకతన
ഏകതാ	ఏకతా
ഏകാംശ	ఏకాంశ
ഏകാകാന്യ	ఏకాకాన్య
ഏകാനീ	ఏకానీ
ഏകാപര്നികാ	ఏకాపర్నికా
ഏകേസ്വാര	ఏకేస్వార
ഏത്തന	ఏత్తన
ഏധിത	ఏధిత
ഏമാ	ఏమా
ഏലനാ	ఏలనా
ഏലാ	ఏలా
ഏലീലവേംദന	ఏలీలవేందన
ഏലീലീ	ఏలీలీ
ഓഈസീന	ఓఈసీన
ഓജസ്വീ	ఓజస్వీ
ഓജാ	ఓజా
ഓജീസ	ఓజీస
ഓനിശ	ఓనిశ
ഓമപ്രകാശ	ఓమప్రకాశ
ഓവീന	ఓవీన
ഓവൈസ	ఓవైస
കംജ	కంజ
കംജന	కంజన
കംഠന	కంఠన
കംദര്പ	కందర్ప
കംപനാ	కంపనా
കകോന	కకేాన
കതകീ	కతకీ
കതേല്യ്ന	కతేల్య్న
കനക	కనక
കനദ	కనద
കനാകംഗീ	కనాకంగీ
കനീജാ	కనీజా
കനീരാ	కనీరా
കനീസാ	కనీసా
കനുഷ	కనుష
കന്വക	కన్వక
കന്ശീകാ	కన్శీకా
കപാലീന	కపాలీన
കപിലാശ്വര	కపిలాశ్వర
കമലാപതി	కమలాపతి
കമലിനീ	కమలినీ
കമലേക്ഷണ	కమలేక్షణ
കമ്നാ	కమ్నా
കരാലാ	కరాలా
കരീസമാം	కరీసమాం
കരുനാസ്രീ	కరునాస్రీ
കരുപ്പസമ്യ	కరుప్పసమ్య
കര്ണ	కర్ణ
കര്തീഗാ	కర్తీగా
കര്മദീപ	కర్మదీప
കര്മാശ	కర్మాశ
കലരനീ	కలరనీ
കലശ	కలశ
കലാധര	కలాధర
കലാനിധി	కలానిధి
കലാപരണ	కలాపరణ
കലാപീന	కలాపీన
കലാപ്രിയാ	కలాప్రియా
കലൈസേലവീ	కలైసేలవీ
കവന	కవన
കവിപ  പ്രിയ	కవిప  ప్రియ
കവീനാഥ	కవీనాథ
കശ്തീ	కశ్తీ
കാജല	కాజల
കാജീശ	కాజీశ
കാദമ്ബരീ	కాదమ్బరీ
കാധിരോലീ	కాధిరేాలీ
കാനീ	కానీ
കാന്ജീരാ	కాన్జీరా
കാന്തീ	కాన్తీ
കാമത	కామత
കാമിഷാ	కామిషా
കാമേശ	కామేశ
കാരുണ്യ പ്രകാശ	కారుణ్య ప్రకాశ
കാരൂകാ	కారూకా
കാര്നിക	కార్నిక
കാലിക	కాలిక
കാലിപദാ	కాలిపదా
കാലിയാ	కాలియా
കാലീതാ	కాలీతా
കാവ്യ ശ്രീ	కావ్య శ్రీ
കിന്നേരാ	కిన్నేరా
കീഅനാ	కీఅనా
കീജല	కీజల
കീനാരീ	కీనారీ
കീന്ചനാ	కీన్చనా
കേകലാ	కేకలా
കേതന	కేతన
കേനിഷാ	కేనిషా
കേളവ്യ	కేళవ్య
കൈരവീ	కైరవీ
കൈലാശ	కైలాశ
കോശേല	కేాశేల
കൌശികാ	కెౌశికా
ഖഗേശ	ఖగేశ
ഖമീശ	ఖమీశ
ഖാതീരാവണ	ఖాతీరావణ
ഖാത്വന്ഗീന	ఖాత్వన్గీన
ഖീലതീ	ఖీలతీ
ഖുസീ	ఖుసీ
ഗംഗാ	గంగా
ഗംദേശാ	గందేశా
ഗംധാര	గంధార
ഗംധാരാ	గంధారా
ഗംധാലീ	గంధాలీ
ഗഗന	గగన
ഗജവദന	గజవదన
ഗജേന്ദ്ര	గజేన్ద్ర
ഗണക	గణక
ഗണനാ പംഡിതന	గణనా పండితన
ഗണനാഥ	గణనాథ
ഗണ്യാ	గణ్యా
ഗതി	గతి
ഗനേസന	గనేసన
ഗന്ഗസീരുവന	గన్గసీరువన
ഗയാലികാ	గయాలికా
ഗരിമാ	గరిమా
ഗരിഷ്ട	గరిష్ట
ഗരുല	గరుల
ഗാഇശ	గాఇశ
ഗാന്ഗമൈന്ദന	గాన్గమైన్దన
ഗാമിനീ	గామినీ
ഗായത്രീ	గాయత్రీ
ഗായലേ	గాయలే
ഗിഅന	గిఅన
ഗിയാ	గియా
ഗിരിവര	గిరివర
ഗീതി	గీతి
ഗീതീശാ	గీతీశా
ഗുംജാ	గుంజా
ഗുനാജാ	గునాజా
ഗുനാരത്നാ	గునారత్నా
ഗുനാശേകാര	గునాశేకార
ഗുനീന	గునీన
ഗുന്ജീതാ	గున్జీతా
ഗുപ്തക	గుప్తక
ഗുരദയാല	గురదయాల
ഗുരദേവ	గురదేవ
ഗുരബാനീ	గురబానీ
ഗുരമാന	గురమాన
ഗുരുത്തമ	గురుత్తమ
ഗുര്നാന്ഡീശ	గుర్నాన్డీశ
ഗുലമോഹര	గులమేాహర
ഗുവീദ	గువీద
ഗൂംജീതാ	గూంజీతా
ഗൂഹാരീ	గూహారీ
ഗേനേലിയാ	గేనేలియా
ഗേശനാ	గేశనా
ഗോപാല	గేాపాల
ഗോപീ നാഥ	గేాపీ నాథ
ഗോഭില	గేాభిల
ഗോരഖ-നാഥ	గేారఖ-నాథ
ഗൌരവീ	గెౌరవీ
ഗൌരീകാംത	గెౌరీకాంత
ഗൌരീശ	గెౌరీశ
ഗൌര്പ്രിയാ	గెౌర్ప్రియా
ഗ്രീതേശ	గ్రీతేశ
ഗ്രീവാ	గ్రీవా
ഗ്രീശ്മീതാ	గ్రీశ్మీతా
ഗ്രീഷ്മ	గ్రీష్మ
ഘടോതകത്ചാ	ఘటేాతకత్చా
ചംചലാ	చంచలా
ചംദേര്ഭാന	చందేర్భాన
ചംദ്രകാംത	చంద్రకాంత
ചംദ്രകാംതാ	చంద్రకాంతా
ചംദ്രചുര	చంద్రచుర
ചംദ്രപുശ്പാ	చంద్రపుశ్పా
ചംദ്രപ്രകാശ	చంద్రప్రకాశ
ചംദ്രമതി	చంద్రమతి
ചംദ്രലേഖാ	చంద్రలేఖా
ചംദ്രഹാസ	చంద్రహాస
ചംദ്രാനന	చంద్రానన
ചംദ്രാഭാ	చంద్రాభా
ചംദ്രേശ	చంద్రేశ
ചകേശ	చకేశ
ചകോര	చకేార
ചക്ഷസ	చక్షస
ചതുര	చతుర
ചതുരാ	చతురా
ചതുര്ഭുജാ	చతుర్భుజా
ചതുര്വേദീ	చతుర్వేదీ
ചത്രീയാ	చత్రీయా
ചന്ദ്രകേതു	చన్ద్రకేతు
ചരണ	చరణ
ചരന്യാ	చరన్యా
ചലാമാ	చలామా
ചാംദ	చాంద
ചാനാസ്യാ	చానాస్యా
ചാനേ	చానే
ചാന്ദനികാ	చాన్దనికా
ചാരുന	చారున
ചാരുവീ	చారువీ
ചാര്മീ	చార్మీ
ചാര്വീ	చార్వీ
ചാവ്രിക	చావ్రిక
ചിത്കലാ	చిత్కలా
ചിത്ത	చిత్త
ചിത്തപ്രസാദ	చిత్తప్రసాద
ചിത്തരംജന	చిత్తరంజన
ചിത്തരംജനീ	చిత్తరంజనీ
ചിത്രകുന്ധാലാ	చిత్రకున్ధాలా
ചിത്രകേതു	చిత్రకేతు
ചിത്രഗംധാ	చిత్రగంధా
ചിത്രബാനാ	చిత్రబానా
ചിത്രമാലാ	చిత్రమాలా
ചിത്രര്ത	చిత్రర్త
ചിത്രല	చిత్రల
ചിത്രലേഖാ	చిత్రలేఖా
ചിത്രാദീപ	చిత్రాదీప
ചിത്രീനീ	చిత్రీనీ
ചിദംബര	చిదంబర
ചിദാനംദാ	చిదానందా
ചിനാര	చినార
ചിന്നാദുരാഈ	చిన్నాదురాఈ
ചിമന	చిమన
ചീദാര്ത	చీదార్త
ചീന്മയേ	చీన్మయే
ചീരുഷ	చీరుష
ചേതന്ദീപ	చేతన్దీప
ചേതള	చేతళ
ചേഥാസാ	చేథాసా
ചേമ്മല	చేమ్మల
ചേര്വിക	చేర్విక
ചേലന	చేలన
ചേലിയാഁ	చేలియాഁ
ചൈതന്യാ	చైతన్యా
ചൈത്രാ	చైత్రా
ചൈരാവലീ	చైరావలీ
ഛായാംക	ఛాయాంక
ജക്ഷ	జక్ష
ജക്ഷാനീ	జక్షానీ
ജഗതപ്രകാശ	జగతప్రకాశ
ജഗദഗുരു	జగదగురు
ജഗദമ്ബാ	జగదమ్బా
ജഗനമോഹിനീ	జగనమేాహినీ
ജഗന്മയീ	జగన్మయీ
ജഗ്വീ	జగ్వీ
ജഗ്വീര	జగ్వీర
ജജ്വാല്യാ	జజ్వాల్యా
ജടായു	జటాయు
ജനഹിതാ	జనహితా
ജനാദേവ	జనాదేవ
ജനാവ	జనావ
ജനിത	జనిత
ജമാംദാഗ്ന്യ മഹാദാര്പാ	జమాందాగ్న్య మహాదార్పా
ജമ്ബവതപ്രീതി	జమ్బవతప్రీతి
ജയംത	జయంత
ജയചംദ	జయచంద
ജയപാല	జయపాల
ജയമാലാ	జయమాలా
ജയശ്രീ	జయశ్రీ
ജയാകീര്തന	జయాకీర్తన
ജയാകേതന	జయాకేతన
ജയാപാദമാം	జయాపాదమాం
ജയായ	జయాయ
ജയിത	జయిత
ജയേശ	జయేశ
ജലദ	జలద
ജല്പേശ	జల్పేశ
ജശവംത	జశవంత
ജസീത്താ	జసీత్తా
ജസ്സീ	జస్సీ
ജാനകീ	జానకీ
ജാനകീദാസ	జానకీదాస
ജാനകീനാഥ	జానకీనాథ
ജാനകീഭൂഷണ	జానకీభూషణ
ജാനഹിതാ	జానహితా
ജാപക	జాపక
ജായിത്രീ	జాయిత్రీ
ജിനേശ്വര	జినేశ్వర
ജിഹാന	జిహాన
ജീതേശ	జీతేశ
ജീന്ദാല	జీన్దాల
ജീവനകലാ	జీవనకలా
ജീവനീ	జీవనీ
ജീവന്തീനീ	జీవన్తీనీ
ജുഷ്ടി	జుష్టి
ജേനീശാ	జేనీశా
ജേര്ശീകാ	జేర్శీకా
ജൈകാപിശ	జైకాపిశ
ജൈചരണ	జైచరణ
ജൈനീശ	జైనీశ
ജൈപ്രകാശ	జైప్రకాశ
ജൈവംത	జైవంత
ജൈസല	జైసల
ജൈഹാസീനീ	జైహాసీనీ
ജോംഫീ	జేాంఫీ
ജോശനീകാ	జేాశనీకా
ജോശീതാ	జేాశీతా
ജ്വാലാ	జ్వాలా
ജ്ഹില	జ్హిల
ജ്ഹീണൂക	జ్హీణూక
ഝഹനവീ	ఝహనవీ
ഝാനീശാ	ఝానీశా
ഝാരാ	ఝారా
ഝീയാ	ఝీయా
ഝേനീശാ	ఝేనీశా
ഝ്യാനനീ	ఝ్యాననీ
ടീംകു	టీంకు
ഠുമരീ	ఠుమరీ
തക്ശീ	తక్శీ
തക്ശീല	తక్శీల
തജജ്ഞ	తజజ్ఞ
തനവീ	తనవీ
തനിഷ്ക	తనిష్క
തനുംജാശ്രീ	తనుంజాశ్రీ
തനുംശ്കാ	తనుంశ్కా
തനോജ	తనేాజ
തപസ	తపస
തപസ്വിനീ	తపస్వినీ
തമില  സേല്വീ	తమిల  సేల్వీ
തമിശ	తమిశ
തമോഘ്നാ	తమేాఘ్నా
തമോനഷ	తమేానష
തരംജോത	తరంజేాత
തരനീ	తరనీ
തരലാ	తరలా
തരീനീ	తరీనీ
തരുശ്രീ	తరుశ్రీ
തരൂണീ	తరూణీ
തവലീന :	తవలీన :
തവിഷാ	తవిషా
തസ്യ	తస్య
താക്ഷ്യാ	తాక్ష్యా
താജേന്ദര	తాజేన్దర
താനാരുപീ	తానారుపీ
താനിയാ	తానియా
താന്വീഥാ	తాన్వీథా
താപീ	తాపీ
താരികാ	తారికా
താരീനീ	తారీనీ
താരൂശ	తారూశ
താലംക	తాలంక
താലീന	తాలీన
താലേശ	తాలేశ
താവന	తావన
താവീശാ	తావీశా
തിതലീ	తితలీ
തിനാശ	తినాశ
തിലക	తిలక
തീഈവ്യേശ	తీఈవ్యేశ
തീര്ഥാ	తీర్థా
തീസ്ചാ	తీస్చా
തുത്തീ	తుత్తీ
തുനാവാ	తునావా
തുന്ഗാര	తున్గార
തുപമ	తుపమ
തുരഗ	తురగ
തുശീഥാ	తుశీథా
തൃപേശ	తృపేశ
തേജസ	తేజస
തേജസ്വീ	తేజస్వీ
തേജസ്വീന	తేజస్వీన
തേജേനദര	తేజేనదర
തേജോമയ	తేజేామయ
തോയേശ	తేాయేశ
തോശീകാ	తేాశీకా
തൌരുസ	తెౌరుస
ത്രികായാ	త్రికాయా
ത്രിപുരസുംദരീ	త్రిపురసుందరీ
ത്രിഭുവന	త్రిభువన
ത്രിമാന	త్రిమాన
ത്രിമൂര്തി	త్రిమూర్తి
ത്രിവേണീ	త్రివేణీ
ത്രിശല	త్రిశల
ത്രിശലാനാ	త్రిశలానా
ത്രീഝ്യാ	త్రీఝ్యా
ത്രീതിയാ	త్రీతియా
ത്രീനേശ	త్రీనేశ
ത്രീപന	త్రీపన
ത്രീപ്ത	త్రీప్త
ത്രീവീദ	త్రీవీద
ത്വരിതാ	త్వరితా
ത്വീശീ	త్వీశీ
ത്വേസാ	త్వేసా
ഥംസീ	థంసీ
ഥനീരികാ	థనీరికా
ഥാകാപ്പന്സ്വാമീ	థాకాప్పన్స్వామీ
ഥാരികാ	థారికా
ഥാവനീ	థావనీ
ഥീരീശ്കാ	థీరీశ్కా
ഥുസീഥാ	థుసీథా
ഥ്രേശാ	థ్రేశా
ദംദാപാനീ	దందాపానీ
ദക്ഷാഹതാ	దక్షాహతా
ദബീത	దబీత
ദബ്ന്ശും	దబ్న్శుం
ദയാദാ	దయాదా
ദയാനിതാ	దయానితా
ദരഹാസ	దరహాస
ദര്ശ	దర్శ
ദര്ശക	దర్శక
ദര്ശികാ	దర్శికా
ദര്ശീനീ	దర్శీనీ
ദര്സീകാ	దర్సీకా
ദശാഗ്രീവാ ശീരോഹരാ	దశాగ్రీవా శీరేాహరా
ദശാഗ്രീവാകുലാന്താകാ	దశాగ్రీవాకులాన్తాకా
ദശാനന	దశానన
ദഹാ	దహా
ദാനാസ്വീ	దానాస్వీ
ദാനുംശ്രീ	దానుంశ్రీ
ദാന്ദാകാരാന്യ പുന്യകൃതേ	దాన్దాకారాన్య పున్యకృతే
ദാരുല	దారుల
ദാഹക	దాహక
ദികീശംദ	దికీశంద
ദിഗീശാ	దిగీశా
ദിപംശീ	దిపంశీ
ദിപശീകീ	దిపశీకీ
ദിപേംദര	దిపేందర
ദിപ്താ	దిప్తా
ദിബസരീ	దిబసరీ
ദിവീഥാ	దివీథా
ദിവേനാ	దివేనా
ദീതാ	దీతా
ദീനബംധു	దీనబంధు
ദീപഥീ	దీపథీ
ദീപപ്രഭാ	దీపప్రభా
ദീപമാലാ	దీపమాలా
ദീപശിഖാ	దీపశిఖా
ദീപാംജലി	దీపాంజలి
ദീപാശാ	దీపాశా
ദീപിത	దీపిత
ദീവാംശ	దీవాంశ
ദേജ	దేజ
ദേബജ്യോതീ	దేబజ్యేాతీ
ദേബദാത്താ	దేబదాత్తా
ദേബദ്രിതാ	దేబద్రితా
ദേബന്ശീ	దేబన్శీ
ദേയ്വയാനാകാന്തന	దేయ్వయానాకాన్తన
ദേവഗര്ഭാ	దేవగర్భా
ദേവജ്യോതി	దేవజ్యేాతి
ദേവദാന	దేవదాన
ദേവന്ദ്ര	దేవన్ద్ర
ദേവമദാനാ	దేవమదానా
ദേവരാജ	దేవరాజ
ദേവശ്രീ	దేవశ్రీ
ദേവാംഗനാ	దేవాంగనా
ദേവാംഗീ	దేవాంగీ
ദേവാംശു	దేవాంశు
ദേവാദീത്യാ	దేవాదీత్యా
ദേവാനീ	దేవానీ
ദേവാന്ശാ	దేవాన్శా
ദേവാപ്രിയാ	దేవాప్రియా
ദേവാമനോഹാരീ	దేవామనేాహారీ
ദേവീന	దేవీన
ദേവീലാല	దేవీలాల
ദേവേന	దేవేన
ദേവേശീ	దేవేశీ
ദേവ്യഹ്നാന	దేవ్యహ్నాన
ദേശാവംത	దేశావంత
ദൈത്യാകുലാന്താകാ	దైత్యాకులాన్తాకా
ദൈവ്യാ	దైవ్యా
ധക്ശീന്യ	ధక్శీన్య
ധനസുഖ	ధనసుఖ
ധനാജീ	ధనాజీ
ധനിഷ്ഠ	ధనిష్ఠ
ധനു	ధను
ധനുജാ	ధనుజా
ധനേശീ	ధనేశీ
ധന്വികാ	ధన్వికా
ധരമനിഷ്ഠ	ధరమనిష్ఠ
ധരാമാം	ధరామాం
ധരാഹാസീനീ	ధరాహాసీనీ
ധരീശ	ధరీశ
ധര്മ  ദുത്ത	ధర్మ  దుత్త
ധര്മഅധ്യക്ഷ	ధర్మఅధ్యక్ష
ധര്മദിത്യ	ధర్మదిత్య
ധര്മദേവ	ధర్మదేవ
ധര്ശീതാ	ధర్శీతా
ധര്ശീനീ	ధర్శీనీ
ധാമീനീ	ధామీనీ
ധാരാനീ	ధారానీ
ധിതി	ధితి
ധിതീ	ధితీ
ധീപ്ത്ഹാ	ధీప్త్హా
ധീമാഹീ	ధీమాహీ
ധീര്ഥാ	ధీర్థా
ധേയാംശീ	ధేయాంశీ
ധൈര്യ്യാ	ధైర్య్యా
ധ്യുഥീ	ధ్యుథీ
ധ്രുമീ	ధ్రుమీ
നംദക	నందక
നംദു	నందు
നക്ശ	నక్శ
നക്സത്രരാജാ	నక్సత్రరాజా
നഗമാനീ	నగమానీ
നടവര	నటవర
നത്രീശാ	నత్రీశా
നദീപ	నదీప
നഭാ	నభా
നഭോമാനീ	నభేామానీ
നമന	నమన
നമനാ	నమనా
നയന	నయన
നരേന്ദ്രന	నరేన్ద్రన
നരേന്ദ്രനാഥ	నరేన్ద్రనాథ
നരേശ	నరేశ
നവനീത വിലീപ്തംഗാ	నవనీత విలీప్తంగా
നവമ	నవమ
നവരംഗ	నవరంగ
നസീബ	నసీబ
നാംബീ	నాంబీ
നാഗനാഥ	నాగనాథ
നാഗപാല	నాగపాల
നാഗേശ്വരണ	నాగేశ్వరణ
നാഗൈഃ	నాగైః
നാതാഭൈരവീ	నాతాభైరవీ
നാതിന	నాతిన
നാന്ധീനീ	నాన్ధీనీ
നാന്നാന	నాన్నాన
നാഭിതാ	నాభితా
നാഭേംദു	నాభేందు
നാമത	నామత
നായകീ	నాయకీ
നായാനീ	నాయానీ
നായാനീകാ	నాయానీకా
നാലിനികാംത	నాలినికాంత
നാലീനേശയ	నాలీనేశయ
നാവീന്യ	నావీన్య
നാവീല	నావీల
നാവ്യാ ദുര്ഗാ	నావ్యా దుర్గా
നാവ്രീതാ	నావ్రీతా
നികാരാ	నికారా
നിഖിതാ	నిఖితా
നിഖില	నిఖిల
നിജു	నిజు
നിധി	నిధి
നിധിപാ	నిధిపా
നിപാ	నిపా
നിരംജനാ	నిరంజనా
നിരമഈ	నిరమఈ
നിരുപമാ	నిరుపమా
നിര്മളാ	నిర్మళా
നിര്മിതി	నిర్మితి
നിലാശാ	నిలాశా
നിശാനഥീ	నిశానథీ
നീഗീഥാ	నీగీథా
നീതു	నీతు
നീഥീകാ	నీథీకా
നീധാ	నీధా
നീധാര്സനാ	నీధార్సనా
നീമാംലന	నీమాంలన
നീരാലികാ	నీరాలికా
നീരൈമാംഥീ	నీరైమాంథీ
നീര്മുകതാ	నీర్ముకతా
നീല മാധവ	నీల మాధవ
നീലംജന	నీలంజన
നീലക്ഷ	నీలక్ష
നീല്ജാ	నీల్జా
നീശാലീ	నీశాలీ
നീശീതീ	నీశీతీ
നീശ്മീഥാ	నీశ్మీథా
നീസ്ചീഥാ	నీస్చీథా
നീഹാ	నీహా
നേമീശാ	నేమీశా
നേയ്സാ	నేయ్సా
നേരീശാ	నేరీశా
നൈജാ	నైజా
നൈരീതീ	నైరీతీ
നൈവേധീ	నైవేధీ
നൌസദ	నెౌసద
പംകജന	పంకజన
പംചഭൂതാത്മികാ	పంచభూతాత్మికా
പംഥീനീ	పంథీనీ
പഝ്ഹേനീ	పఝ్హేనీ
പത്താമ്ബരാപരീധാനാ	పత్తామ్బరాపరీధానా
പത്ര	పత్ర
പന്ദാലാവാസന	పన్దాలావాసన
പമ്പാ	పమ్పా
പമ്ഫാ	పమ్ఫా
പയാസ	పయాస
പയോധീ	పయేాధీ
പരംതാപാ	పరంతాపా
പരമാംത്മികാ	పరమాంత్మికా
പരമാംന്ത്ര	పరమాంన్త్ర
പരമിലാ	పరమిలా
പരമേശ്വരീ	పరమేశ్వరీ
പരമ്വാര്ദാന	పరమ్వార్దాన
പരവാനീ	పరవానీ
പരവിംദര	పరవిందర
പരാകാഷ	పరాకాష
പരാവീ	పరావీ
പരിഹാ	పరిహా
പര്തീബന	పర్తీబన
പര്ലീ	పర్లీ
പര്വ	పర్వ
പലാക്ഷ	పలాక్ష
പലാശീനീ	పలాశీనీ
പവന	పవన
പവനസുത	పవనసుత
പശുപതി	పశుపతి
പഹലാജ	పహలాజ
പാടലാ	పాటలా
പാന്ദുരംഗാ	పాన్దురంగా
പായല	పాయల
പാരു	పారు
പാര്ഥിക	పార్థిక
പാര്ഥീവീ	పార్థీవీ
പാര്ഥോ	పార్థేా
പാളവീ	పాళవీ
പാവകീ	పావకీ
പാവനാ	పావనా
പാവാനാ	పావానా
പാഹീ	పాహీ
പിവാല	పివాల
പൂജന	పూజన
പൂരതീ	పూరతీ
പൂരികാ	పూరికా
പൂര്വജാ	పూర్వజా
പൂര്വികാ	పూర్వికా
പേഖമ	పేఖమ
പേത്ചീ	పేత్చీ
പേരാരസീ	పేరారసీ
പ്രകൃഥീ	ప్రకృథీ
പ്രഗന്യാ	ప్రగన్యా
പ്രഗ്യപരാമിതാ	ప్రగ్యపరామితా
പ്രജാനാ	ప్రజానా
പ്രനാദാ	ప్రనాదా
പ്രനീധാനാ	ప్రనీధానా
പ്രബകരണ	ప్రబకరణ
പ്രഭാകര	ప్రభాకర
പ്രഭാകരന	ప్రభాకరన
പ്രഭാത	ప్రభాత
പ്രഭാവ	ప్రభావ
പ്രാതീകാ	ప్రాతీకా
ഫനീ	ఫనీ
ഫനീഭുഷണ	ఫనీభుషణ
ഫാല്ഗുനീ	ఫాల్గునీ
ഫൂലന	ఫూలన
ഫ്രാന്ചീസ	ఫ్రాన్చీస
ബംദിശ	బందిశ
ബംധൂല	బంధూల
ബംശീ	బంశీ
ബംസീധര	బంసీధర
ബകുലാ	బకులా
ബകൂല	బకూల
ബദ്രീ	బద్రీ
ബനജ	బనజ
ബനവാരീ	బనవారీ
ബബന	బబన
ബബിശ	బబిశ
ബര്ഹന	బర్హన
ബലബീര	బలబీర
ബഹവാസ്യ	బహవాస్య
ബാബു	బాబు
ബാബുല	బాబుల
ബാല മുകുന്ദ	బాల ముకున్ద
ബാലധി	బాలధి
ബാലാമോഹന	బాలామేాహన
ബാലാരാജ	బాలారాజ
ബാലാശംകര	బాలాశంకర
ബാലു	బాలు
ബാലേന്ദു	బాలేన్దు
ബാസ്കാര	బాస్కార
ബിനീതാ	బినీతా
ബീനും	బీనుం
ബീന്ദുശ്രീ	బీన్దుశ్రీ
ബീന്നീകേര	బీన్నీకేర
ബീപുല	బీపుల
ബീബീന	బీబీన
ബീരത	బీరత
ബീഹാന	బీహాన
ബേനീതാ	బేనీతా
ബേനും	బేనుం
ബേലുരമീ	బేలురమీ
ബേല്ലീ	బేల్లీ
ബൈവാവീ	బైవావీ
ബൈസാഖീ	బైసాఖీ
ബ്രീഥ്ഹീ	బ్రీథ్హీ
ബ്ലേസ്സീ	బ్లేస్సీ
ഭഗവാന	భగవాన
ഭദ്രക്ഷ	భద్రక్ష
ഭദ്രനിധി	భద్రనిధి
ഭദ്രപ്രിയാ	భద్రప్రియా
ഭദ്രിക	భద్రిక
ഭദ്രീശാ	భద్రీశా
ഭവാനീ	భవానీ
ഭവ്യരാജ	భవ్యరాజ
ഭാഗവംതീ	భాగవంతీ
ഭാദരന	భాదరన
ഭാനുമിത്ര	భానుమిత్ర
ഭാരഥീ	భారథీ
ഭാര്ഗവന	భార్గవన
ഭാര്ഗവാ	భార్గవా
ഭാര്ഘവീ	భార్ఘవీ
ഭാര്ദ്ദ്വാജ	భార్ద్ద్వాజ
ഭാലേംദ്ര	భాలేంద్ర
ഭാവതീ	భావతీ
ഭാവീഗുരും	భావీగురుం
ഭാവ്യമ	భావ్యమ
ഭാശ്വീനീ	భాశ్వీనీ
ഭാസു	భాసు
ഭാസ്കാരീ	భాస్కారీ
ഭാസ്കേര	భాస్కేర
ഭീമശംകര	భీమశంకర
ഭൂദേവ	భూదేవ
ഭൂപത	భూపత
ഭൂപാല	భూపాల
ഭൂമാ	భూమా
ഭൂമാം	భూమాం
ഭേരേശ	భేరేశ
ഭൈരവീ	భైరవీ
മംഗലമ	మంగలమ
മംഗേശ	మంగేశ
മംജു  പ്രസന്ന	మంజు  ప్రసన్న
മംജുനാഥ	మంజునాథ
മംജുലാ	మంజులా
മംത	మంత
മംതോഷ	మంతేాష
മംദിഥാ	మందిథా
മംദിരാ	మందిరా
മകാലീ	మకాలీ
മകുര	మకుర
മഗന	మగన
മണികാംത	మణికాంత
മദുരാ	మదురా
മധുനിഷാ	మధునిషా
മധുമാംലീ	మధుమాంలీ
മധുരിമാ	మధురిమా
മധുവംതീ	మధువంతీ
മനജീത	మనజీత
മനപ	మనప
മനസ്വിന	మనస్విన
മനാല്പ	మనాల్ప
മനീതാ	మనీతా
മനീഷ	మనీష
മനോജ	మనేాజ
മനോരനജനീ	మనేారనజనీ
മനോരിഥാ	మనేారిథా
മന്നത	మన్నత
മന്മായീ	మన్మాయీ
മല്ലികാ	మల్లికా
മഹംത	మహంత
മഹാതപസ്വീ	మహాతపస్వీ
മഹാദുര്ഗാ	మహాదుర్గా
മഹാദേവാ	మహాదేవా
മഹാദേവാദീപുജീതാ	మహాదేవాదీపుజీతా
മഹാന്തേശ	మహాన్తేశ
മഹാബാലാ	మహాబాలా
മഹാസ്വേതാ	మహాస్వేతా
മഹിപതി	మహిపతి
മഹിഷാസുരമര്ദിനീ	మహిషాసురమర్దినీ
മഹീജിത	మహీజిత
മഹേംദ്രാ	మహేంద్రా
മഹേശ	మహేశ
മഹേശനീ	మహేశనీ
മഹേശീ	మహేశీ
മാംതിക	మాంతిక
മാംനീമോഝ്ഹീ	మాంనీమేాఝ్హీ
മാംനുസരീ	మాంనుసరీ
മാംന്ക്ഷ	మాంన్క్ష
മാംന്ഗീരീ	మాంన్గీరీ
മാംന്താവ്യാഹ	మాంన్తావ్యాహ
മാംന്തീകാ	మాంన్తీకా
മാംന്ദീതാ	మాంన్దీతా
മാംലാമാംകാല മകാന	మాంలామాంకాల మకాన
മാഇല	మాఇల
മാനകാ	మానకా
മാനജ	మానజ
മാനശ	మానశ
മാനിക	మానిక
മാനീശീന	మానీశీన
മാനോരിത	మానేారిత
മാന്കന	మాన్కన
മാന്ദാവിക	మాన్దావిక
മായാ	మాయా
മാര്ഗശീ	మార్గశీ
മാര്ഗീ	మార్గీ
മാര്തംദ	మార్తంద
മാര്ഥീകാ	మార్థీకా
മാര്യ	మార్య
മാര്യാ	మార్యా
മാര്ഷാ	మార్షా
മാലാര്കോഡീ	మాలార్కేాడీ
മാലിനീ	మాలినీ
മാല്ലേശാ	మాల్లేశా
മാസൂമ	మాసూమ
മാസൂമീ	మాసూమీ
മാഹിയാ	మాహియా
മാഹിരാജ	మాహిరాజ
മാഹുലീ	మాహులీ
മിലീ	మిలీ
മിഹീകാ	మిహీకా
മീനാ	మీనా
മേധ	మేధ
മേധീനീ	మేధీనీ
മൈത്രായ	మైత్రాయ
മൌലീശാ	మెౌలీశా
മ്യ്ഥിലീ	మ్య్థిలీ
യംശ	యంశ
യക്ഷ	యక్ష
യജും	యజుం
യജുസ	యజుస
യജ്നേശ	యజ్నేశ
യഥാര്ഥ	యథార్థ
യദുനംദന	యదునందన
യശസ്വിനീ	యశస్వినీ
യശാശ്രീ	యశాశ్రీ
യശ്ദീപ	యశ్దీప
യശ്മിത	యశ్మిత
യശ്മിതാ	యశ్మితా
യശ്വാര്ധാനാ	యశ్వార్ధానా
യശ്വീന	యశ్వీన
യശ്വീനീ	యశ్వీనీ
യസ്വംഥ	యస్వంథ
യാക്സീനീ	యాక్సీనీ
യാഗ്നാകായാ	యాగ్నాకాయా
യാഗ്നീഥാ	యాగ్నీథా
യാചന	యాచన
യാതീരാജു	యాతీరాజు
യാദവീ	యాదవీ
യാദവേന്ദ്ര	యాదవేన్ద్ర
യാന്തി	యాన్తి
യാശ്രീഥാ	యాశ్రీథా
യാഷ്ക	యాష్క
യാസസ്വീ	యాసస్వీ
യുഗന്തീകാ	యుగన్తీకా
യുഗപ	యుగప
യുഗാന്ധര	యుగాన్ధర
യുതി	యుతి
യുവംശ	యువంశ
യുവനാഥ	యువనాథ
യുവല	యువల
യുവാഥീ	యువాథీ
യുവാന  സൂര്യ	యువాన  సూర్య
യുവ്നീക	యువ్నీక
യേര്രപ്പാ	యేర్రప్పా
യേശനാ	యేశనా
യേശാസ്വീനീ	యేశాస్వీనీ
യേസസരീ	యేససరీ
യോഗദേവാ	యేాగదేవా
യോഗരാജ	యేాగరాజ
യോഗാനംദ	యేాగానంద
യോഗിത	యేాగిత
യോഗിതാ	యేాగితా
യോഗിഥ	యేాగిథ
യോഗേശ്വര	యేాగేశ్వర
യോഗ്ദീപ	యేాగ్దీప
യോത്ശനാ	యేాత్శనా
യോനേന്ദ്ര	యేానేన్ద్ర
യോഹ്ശീനീ	యేాహ్శీనీ
യൌവാനീ	యెౌవానీ
രംഗനാഥ	రంగనాథ
രംജന	రంజన
രംജികാ	రంజికా
രംജീവ	రంజీవ
രഈര്ഥ	రఈర్థ
രക്ത	రక్త
രക്തകമള	రక్తకమళ
രക്ഷികാ	రక్షికా
രക്ഷിത	రక్షిత
രഘവാ	రఘవా
രഘവേന്ദര	రఘవేన్దర
രഘുനാഥ	రఘునాథ
രജത	రజత
രജനീശ	రజనీశ
രജനേശ	రజనేశ
രജീത	రజీత
രതന	రతన
രതാംജലി	రతాంజలి
രതീക	రతీక
രതുല	రతుల
രത്നാകര	రత్నాకర
രത്നാബലീ	రత్నాబలీ
രഥനാ	రథనా
രന്യ	రన్య
രന്വിഥാ	రన్విథా
രബേക	రబేక
രമാംസ്വമ്യ	రమాంస్వమ్య
രമ്ബേശ	రమ్బేశ
രയാന	రయాన
രര്ശ്മീതാ	రర్శ్మీతా
രവി കാന്ത	రవి కాన్త
രവികാംത	రవికాంత
രവിത	రవిత
രവീജാ	రవీజా
രവീനാ	రవీనా
രവ്യംകീ	రవ్యంకీ
രശീലാ	రశీలా
രസവംത	రసవంత
രസ്മീന	రస్మీన
രാഈ കുമാര	రాఈ కుమార
രാഖീ	రాఖీ
രാഗാവ	రాగావ
രാഗിനീ	రాగినీ
രാഗേശ	రాగేశ
രാഗ്വേദ	రాగ్వేద
രാജക	రాజక
രാജകന്യാ	రాజకన్యా
രാജഗോപാല	రాజగేాపాల
രാജയവര്ദന	రాజయవర్దన
രാജാ	రాజా
രാജാര്ശീ	రాజార్శీ
രാജികാ	రాజికా
രാജീവ	రాజీవ
രാജേംദ്രമോഹന	రాజేంద్రమేాహన
രാജേശ്വര	రాజేశ్వర
രാജ്യശ്രീ	రాజ్యశ్రీ
രാധാനീ	రాధానీ
രാനീ	రానీ
രാമ  കീന്കാര	రామ  కీన్కార
രാമഗോപാല	రామగేాపాల
രാമചന്ദ്രന	రామచన్ద్రన
രാമനാരായണ	రామనారాయణ
രാമരാ	రామరా
രാമരാജ	రామరాజ
രാമാംസുഗ്രീവാ	రామాంసుగ్రీవా
രാമാനംദ	రామానంద
രാമാനുജമ	రామానుజమ
രാമോജീ	రామేాజీ
രാഹിത്യ	రాహిత్య
രാഹീന്യ	రాహీన్య
രാഹുലരാജ	రాహులరాజ
രിദ്ധി	రిద్ధి
രീചികാ	రీచికా
രീതൂ	రీతూ
രീഥേകാ	రీథేకా
രീദേവ	రీదేవ
രീധമാം	రీధమాం
രീഭ്യാ	రీభ్యా
രീശും	రీశుం
രീശ്മേഥാ	రీశ్మేథా
രേഖാ	రేఖా
രേത്വിക	రేత్విక
രേധാ	రేధా
രേനാ	రేనా
രേനേശ	రేనేశ
രേമാംനീകാ	రేమాంనీకా
രേമീ	రేమీ
രേവാതീ	రేవాతీ
രേവീഥാ	రేవీథా
രേശമീ	రేశమీ
രേശ്വീന	రేశ్వీన
രേഹാംശീ	రేహాంశీ
രേഹാനാ	రేహానా
രേഹേഈലാ	రేహేఈలా
രേഹ്നുഘാ	రేహ్నుఘా
രൈവത	రైవత
രൈവതാ	రైవతా
ലംഗീത	లంగీత
ലക്ഷ	లక్ష
ലക്ഷാകീ	లక్షాకీ
ലക്ഷിതാ	లక్షితా
ലക്ഷ്മീകാനതമ	లక్ష్మీకానతమ
ലജ്ജാ	లజ్జా
ലജ്ജാകാ	లజ్జాకా
ലതാ	లతా
ലതേശ	లతేశ
ലവപാല	లవపాల
ലവലീന	లవలీన
ലഹരീ	లహరీ
ലാക്ശേതാ	లాక్శేతా
ലാജവംതീ	లాజవంతీ
ലാതീശ	లాతీశ
ലാനീബന	లానీబన
ലാഭാ	లాభా
ലാമ്ബോധാര	లామ్బేాధార
ലാരീനാ	లారీనా
ലാര്മികാ	లార్మికా
ലാര്രാജ	లార్రాజ
ലാര്ശന	లార్శన
ലാവനീ	లావనీ
ലാവിനാ	లావినా
ലീകേശ	లీకేశ
ലീത്സാ	లీత్సా
ലീനാശാ	లీనాశా
ലീനീത	లీనీత
ലീപാക്ഷീ	లీపాక్షీ
ലീപ്സീകാ	లీప్సీకా
ലീമനാ	లీమనా
ലീലാമഈ	లీలామఈ
ലീശാംത	లీశాంత
ലുസിയാ	లుసియా
ലേഈവീനാ	లేఈవీనా
ലേഖീശാ	లేఖీశా
ലേമാര	లేమార
ലോകനേത്ര	లేాకనేత్ర
ലോകാജനാനീ	లేాకాజనానీ
ലോകാമാത്രീ	లేాకామాత్రీ
ലോകീഥാ	లేాకీథా
ലോകേന്ദ്ര	లేాకేన్ద్ర
ലോഗീനീ	లేాగీనీ
ലോഗേശ്വരണ	లేాగేశ్వరణ
ലോചനാ	లేాచనా
ലോനാ	లేానా
ലോമാംകേശ	లేామాంకేశ
ലോഹിത	లేాహిత
ലോഹിതാശ്വാ	లేాహితాశ్వా
ലൌക്യ	లెౌక్య
വംദിതാ	వందితా
വംസികൃഷ്ണ	వంసికృష్ణ
വനദ	వనద
വനമാംഥീ	వనమాంథీ
വനസ	వనస
വനിനാധ	వనినాధ
വന്ജുല	వన్జుల
വപുസ	వపుస
വയദീശ	వయదీశ
വരലീ	వరలీ
വരിന	వరిన
വരിയാസ	వరియాస
വരുന	వరున
വരുനികാ	వరునికా
വര്ണിത	వర్ణిత
വര്ധമാന	వర్ధమాన
വര്ധാനീ	వర్ధానీ
വര്ധീമൈനകാപുജീതാ	వర్ధీమైనకాపుజీతా
വര്നീശാ	వర్నీశా
വര്ശനേയാ	వర్శనేయా
വര്ശീകാ	వర్శీకా
വര്ശീതാ	వర్శీతా
വര്ശീദ	వర్శీద
വര്ഷനീ	వర్షనీ
വല്ലികാ	వల్లికా
വസംതാ	వసంతా
വസംതീ	వసంతీ
വസീസതാ	వసీసతా
വസുമിത്ര	వసుమిత్ర
വസുസേന	వసుసేన
വാക്പതി	వాక్పతి
വാക്ഷു	వాక్షు
വാച്യ	వాచ్య
വാജ്രക്ഷ	వాజ్రక్ష
വാതത്മാജ	వాతత్మాజ
വാത്സല്യ	వాత్సల్య
വാദിവേലും	వాదివేలుం
വാനര	వానర
വാന്ശുല	వాన్శుల
വാമന	వామన
വാമാംക്ഷീ	వామాంక్షీ
വാമീല	వామీల
വാരനാ	వారనా
വാരുനീ	వారునీ
വാലാരമാംഥീ	వాలారమాంథీ
വാല്ല്മാംനാലന	వాల్ల్మాంనాలన
വാശു	వాశు
വാസുമന	వాసుమన
വാഹിനീ	వాహినీ
വികീശാ	వికీశా
വിക്ഷിത	విక్షిత
വിജയാലക്ഷ്മീ	విజయాలక్ష్మీ
വിജയാശാനഥീ	విజయాశానథీ
വിജീതാ	విజీతా
വിദിശാ	విదిశా
വിദ്യാ	విద్యా
വിദ്യുല	విద్యుల
വിധാഥരീ	విధాథరీ
വിന്ധുജാ	విన్ధుజా
വിബാലീ	విబాలీ
വിഭാവാ	విభావా
വിഭൂതി	విభూతి
വിഭൂഷ	విభూష
വിയാമര്ശ	వియామర్శ
വിരഗനാപതീ	విరగనాపతీ
വിരഭാദ്രപ്പാ	విరభాద్రప్పా
വിരാജ	విరాజ
വിലാശീനീ	విలాశీనీ
വീണാ	వీణా
വീണാധാരീ	వీణాధారీ
വേക്രാംത	వేక్రాంత
വേഗ	వేగ
വേഗവാഹീനീ	వేగవాహీనీ
വേഗീ	వేగీ
വേണു	వేణు
വേത്ത്രീ	వేత్త్రీ
വേത്രിവാല	వేత్రివాల
വേത്രീവേല	వేత్రీవేల
വേദകാര്തിക	వేదకార్తిక
വേദവല്ലീ	వేదవల్లీ
വേദാ	వేదా
വേദാ ശ്രീ	వేదా శ్రీ
വേധാംത	వేధాంత
വേന്കാത്രമണ	వేన్కాత్రమణ
വേന്തന	వేన్తన
വേന്നേലാ	వేన్నేలా
വേന്മതീ	వేన్మతీ
വേലു	వేలు
വേഹംത	వేహంత
വൈകുംഠ	వైకుంఠ
വൈജീനാഥ	వైజీనాథ
വൈദത	వైదత
വൈദേഹീ	వైదేహీ
വൈദ്യുംത	వైద్యుంత
വൈധേ	వైధే
വൈധ്യാത	వైధ్యాత
വൈരാഗ	వైరాగ
വൈരോചന	వైరేాచన
വൈശാലീ	వైశాలీ
വൈശ്വീ	వైశ్వీ
വൈഷ്ണവീ	వైష్ణవీ
വൈസകാ	వైసకా
സംക്രാംതി	సంక్రాంతి
സംഗമിത്ര	సంగమిత్ర
സംഗമീധീരാ	సంగమీధీరా
സംചയ	సంచయ
സംചീതീ	సంచీతీ
സംജേനാ	సంజేనా
സംജോലീ	సంజేాలీ
സംതോക	సంతేాక
സംദിപോന	సందిపేాన
സംദീപ	సందీప
സംദേശ	సందేశ
സംധരാ	సంధరా
സംധ്യാ	సంధ్యా
സംബീതാ	సంబీతా
സംമീതാ	సంమీతా
സംയുക്ത	సంయుక్త
സംവിധാ	సంవిధా
സംവീഥാ	సంవీథా
സംസ്കൃതി	సంస్కృతి
സംഹിത	సంహిత
സക്ശീന്യാ	సక్శీన్యా
സഖ്യാ	సఖ్యా
സഗന	సగన
സഗുനാ	సగునా
സചിതാ	సచితా
സചിദാനംദ വിഗ്രഹ	సచిదానంద విగ్రహ
സചേതന	సచేతన
സച്ചിദാനംദാ	సచ్చిదానందా
സജീത	సజీత
സജീലീ	సజీలీ
സദഗതി	సదగతి
സദഗുനാ	సదగునా
സദാശിവ	సదాశివ
സദിശ	సదిశ
സപനാ	సపనా
സപുഷ്പാ	సపుష్పా
സപ്താബീ	సప్తాబీ
സപ്തോര്ശീ	సప్తేార్శీ
സമജാ	సమజా
സമദര്ശീ	సమదర్శీ
സമഭ്ദ്ധാ	సమభ్ద్ధా
സമരേശ	సమరేశ
സമാംദ്രിതാ	సమాంద్రితా
സമാംര്ധ	సమాంర్ధ
സമാജസ	సమాజస
സമാരാസ്യാ	సమారాస్యా
സമിക	సమిక
സമിരന	సమిరన
സമേംദ്ര	సమేంద్ర
സമേശ	సమేశ
സമ്പൂര്ണ	సమ్పూర్ణ
സമ്പ്രഥ്യ	సమ్ప్రథ్య
സമ്പ്രീതീ	సమ్ప్రీతీ
സമ്രാട	సమ్రాట
സമ്രീധ	సమ్రీధ
സരസംഗീ	సరసంగీ
സലീജ	సలీజ
സഹര്സീതാ	సహర్సీతా
സഹശ്രദ	సహశ్రద
സഹസ്ത്രജീത	సహస్త్రజీత
സഹസ്ത്രബാഹു	సహస్త్రబాహు
സഹീത	సహీత
സഹീരാമ	సహీరామ
സഹ്യ	సహ్య
സാംജ	సాంజ
സാഇ രാമ	సాఇ రామ
സാഈനാഥ	సాఈనాథ
സാചീ	సాచీ
സാജന	సాజన
സാദ്രീശീ	సాద్రీశీ
സാദ്വിഥാ	సాద్విథా
സാധന	సాధన
സാധ്യാ	సాధ్యా
സാനിധ്യ	సానిధ్య
സാമംതാ	సామంతా
സാമ്ഭാ	సామ్భా
സാരണീ	సారణీ
സാരഥീ	సారథీ
സാരികാ	సారికా
സാലവീ	సాలవీ
സാലസാ	సాలసా
സൈകത	సైకత
സൈനീത്യ	సైనీత్య
സൈന്ധന്യ	సైన్ధన్య
സൈലീ	సైలీ
സൈഹാര്സന	సైహార్సన
ഹംസമാലാ	హంసమాలా
ഹംസാവാഥ്യ	హంసావాథ్య
ഹനാര്വീന	హనార్వీన
ഹനീതാ	హనీతా
ഹനുപ	హనుప
ഹനുമാന	హనుమాన
ഹബീതാ	హబీతా
ഹമസാദീപികാ	హమసాదీపికా
ഹമസാനംദീനീ	హమసానందీనీ
ഹമീര	హమీర
ഹരജീത	హరజీత
ഹരജീവന	హరజీవన
ഹരനാധ	హరనాధ
ഹരശും	హరశుం
ഹരികിശന	హరికిశన
ഹരിഗംഗാ	హరిగంగా
ഹരിഗോപാല	హరిగేాపాల
ഹരിദാസ	హరిదాస
ഹരിദ്വാര	హరిద్వార
ഹരിപ്രീത	హరిప్రీత
ഹരിമംതീ	హరిమంతీ
ഹരീ	హరీ
ഹരേശ്വര	హరేశ్వర
ഹര്മീന	హర్మీన
ഹര്ഷണ	హర్షణ
ഹര്സികാ	హర్సికా
ഹശ്മീതാ	హశ్మీతా
ഹസമുഖ	హసముఖ
ഹസീതാ	హసీతా
ഹസ്വീഥാ	హస్వీథా
ഹാര്ദീനീ	హార్దీనీ
ഹാര്ശീനീ	హార్శీనీ
ഹാലിക	హాలిక
ഹിംഡോള	హిండేాళ
ഹിംദോലാ	హిందేాలా
ഹിതാക്ഷീ	హితాక్షీ
ഹിതീ	హితీ
ഹിഥീക്സാ	హిథీక్సా
ഹിമാംശു	హిమాంశు
ഹിമാക്ഷ	హిమాక్ష
ഹിമാലയ	హిమాలయ
ഹിരംയക	హిరంయక
ഹിരവ	హిరవ
ഹിരവാ	హిరవా
ഹിരുധായാ	హిరుధాయా
ഹിവാ	హివా
ഹീരാനമാം	హీరానమాం
ഹീരാന്യാപ്രകാഈ	హీరాన్యాప్రకాఈ
ഹീര്നാക്ഷീ	హీర్నాక్షీ
ഹുവീശ്കാ	హువీశ్కా
ഹൃദയനാഥ	హృదయనాథ
ഹേഈദീ	హేఈదీ
ഹേജല	హేజల
ഹേതാ	హేతా
ഹേതാശ	హేతాశ
ഹേത്ശ്രീ	హేత్శ్రీ
ഹേഥാന്ശ്രീ	హేథాన్శ్రీ
ഹേനീത	హేనీత
ഹേനീല	హేనీల
ഹേമനാഥ	హేమనాథ
ഹേമലതാ	హేమలతా
ഹേമാ	హేమా
ഹേമാംദ്രികാ	హేమాంద్రికా
ഹേമാഗൌരീ	హేమాగెౌరీ
ഹേമാനംദ	హేమానంద
ഹേമാലാ	హేమాలా
ഹേമാവതീ	హేమావతీ
ഹേമാവാതിനംദന	హేమావాతినందన
ഹേമേംദു	హేమేందు
ഹേയന	హేయన
ഹേയാംശ	హేయాంశ
ഹേരീത	హేరీత
ഹേലീ	హేలీ
ഹോന്നേശാ	హేాన్నేశా
ഹോമാ	హేామా
ഹ്രീത്വിക	హ్రీత్విక
ഹ്രീദാന്ക്ഷ	హ్రీదాన్క్ష
ഹ്രീധാന	హ్రీధాన
ഹ്രീശന	హ్రీశన
ഹ്രീശാംത	హ్రీశాంత
ഹ്രീഷിത	హ్రీషిత
ഹ്രുദയ	హ్రుదయ
ഹ്രുശാല	హ్రుశాల
ഹ്രേയാംശ	హ్రేయాంశ
ഹ്ര്യ്ദയേശ	హ్ర్య్దయేశ
#
#
# Territory names from CLDR
അസൻഷൻ ദ്വീപ്	అసൻషൻ ద్వీప్
അന്റോറ	అన్ఱేాఱ
യുണൈറ്റഡ് അറബ് എമിറൈറ്റ്‌സ്	యుణైఱ్ఱడ్ అఱబ్ ఎమిఱైఱ్ఱ్‌స్
അഫ്‌ഗാനിസ്ഥാൻ	అఫ్‌గానిస్థాൻ
ആൻറിഗ്വയും ബർബുഡയും	ఆൻఱిగ్వయుం బർబుడయుం
ആൻഗ്വില്ല	ఆൻగ్విల్ల
അൽബേനിയ	అൽబేనియ
അർമേനിയ	అർమేనియ
അംഗോള	అంగేాళ
അൻറാർട്ടിക്ക	అൻఱాർట్టిక్క
അർജൻറീന	అർజൻఱీన
അമേരിക്കൻ സമോവ	అమేరిక్కൻ సమేావ
ഓസ്ട്രിയ	ఓస్ట్రియ
ഓസ്‌ട്രേലിയ	ఓస్‌ట్రేలియ
അറൂബ	అఱూబ
അലൻഡ് ദ്വീപുകൾ	అలൻడ్ ద్వీపుకൾ
അസർബൈജാൻ	అసർబైజాൻ
ബോസ്നിയയും ഹെർസഗോവിനയും	బేాస్నియయుం హెർసగేావినయుం
ബാർബഡോസ്	బాർబడేాస్
ബംഗ്ലാദേശ്	బంగ్లాదేశ్
ബെൽജിയം	బెൽజియం
ബുർക്കിനാ ഫാസോ	బుർక్కినా ఫాసేా
ബൾഗേറിയ	బൾగేఱియ
ബഹ്റിൻ	బహ్ఱిൻ
ബറുണ്ടി	బఱుణ్టి
ബെനിൻ	బెనిൻ
സെന്റ് ബാർത്തലമി	సెన్ఱ్ బాർత్తలమి
ബർമുഡ	బർముడ
ബ്രൂണൈ	బ్రూణై
ബൊളീവിയ	బెాళీవియ
ബൊണെയ്ർ, സിന്റ് യുസ്റ്റേഷ്യസ്, സാബ എന്നിവ	బెాణెయ్ർ, సిన్ఱ్ యుస్ఱ్ఱేష్యస్, సాబ ఎన్నివ
ബ്രസീൽ	బ్రసీൽ
ബഹാമാസ്	బహామాస్
ഭൂട്ടാൻ	భూట్టాൻ
ബൗവെട്ട് ദ്വീപ്	బౌవెట్ట్ ద్వీప్
ബോട്സ്വാന	బేాట్స్వాన
ബെലറൂസ്	బెలఱూస్
ബെലീസ്	బెలీస్
കാനഡ	కానడ
കോക്കസ് (കീലിംഗ്) ദ്വീപുകൾ	కేాక్కస్ (కీలింగ్) ద్వీపుకൾ
കോംഗോ - കിൻഷാസ	కేాంగేా - కిൻషాస
കോംഗോ (DRC)	కేాంగేా (DRC)
സെൻട്രൽ ആഫ്രിക്കൻ റിപ്പബ്ലിക്	సెൻట్రൽ ఆఫ్రిక్కൻ ఱిప్పబ్లిక్
കോംഗോ - ബ്രാസവില്ലി	కేాంగేా - బ్రాసవిల్లి
കോംഗോ (റിപ്പബ്ലിക്ക്)	కేాంగేా (ఱిప్పబ్లిక్క్)
സ്വിറ്റ്സർലാൻഡ്	స్విఱ్ఱ్సർలాൻడ్
കോട്ട് ഡി വാർ	కేాట్ట్ డి వాർ
ഐവറി കോസ്റ്റ്	ఐవఱి కేాస్ఱ్ఱ్
കുക്ക് ദ്വീപുകൾ	కుక్క్ ద్వీపుకൾ
ചിലി	చిలి
കാമറൂൺ	కామఱూൺ
ചൈന	చైన
കൊളംബിയ	కెాళంబియ
ക്ലിപ്പെർട്ടൻ ദ്വീപ്	క్లిప్పెർట్టൻ ద్వీప్
കോസ്റ്ററിക്ക	కేాస్ఱ్ఱఱిక్క
ക്യൂബ	క్యూబ
കേപ്പ് വെർദെ	కేప్ప్ వెർదె
കുറാകാവോ	కుఱాకావేా
ക്രിസ്മസ് ദ്വീപ്	క్రిస్మస్ ద్వీప్
സൈപ്രസ്	సైప్రస్
ചെക്ക് റിപ്പബ്ലിക്	చెక్క్ ఱిప్పబ్లిక్
ജർമനി	జർమని
ഡീഗോ ഗ്രാഷ്യ	డీగేా గ్రాష్య
ദിജിബൗട്ടി	దిజిబౌట్టి
ഡെൻമാർക്ക്	డెൻమాർక్క్
ഡൊമിനിക്ക	డెామినిక్క
ഡൊമിനിക്കൻ റിപ്പബ്ലിക്	డెామినిక్కൻ ఱిప్పబ్లిక్
അൾജീരിയ	అൾజీరియ
സെയൂത്ത ആൻഡ് മെലിയ	సెయూత్త ఆൻడ్ మెలియ
ഇക്വഡോർ	ఇక్వడేాർ
എസ്റ്റോണിയ‍	ఎస్ఱ్ఱేాణియ‍
ഈജിപ്ത്	ఈజిప్త్
പശ്ചിമ സഹാറ	పశ్చిమ సహాఱ
എറിത്രിയ	ఎఱిత్రియ
സ്‌പെയിൻ	స్‌పెయిൻ
എത്യോപ്യ	ఎత్యేాప్య
യൂറോപ്യൻ യൂണിയൻ	యూఱేాప్యൻ యూణియൻ
ഫിൻലാൻഡ്	ఫిൻలాൻడ్
ഫിജി	ఫిజి
ഫാക്ക്‌ലാന്റ് ദ്വീപുകൾ	ఫాక్క్‌లాన్ఱ్ ద్వీపుకൾ
ഫോക്ക്‌ലാൻഡ് ദ്വീപുകൾ (ഐലാസ് മാൽവിനാസ്)	ఫేాక్క్‌లాൻడ్ ద్వీపుకൾ (ఐలాస్ మాൽవినాస్)
മൈക്രോനേഷ്യ	మైక్రేానేష్య
ഫറോ ദ്വീപുകൾ	ఫఱేా ద్వీపుకൾ
ഫ്രാൻസ്	ఫ్రాൻస్
ഗാബൺ	గాబൺ
യുണൈറ്റഡ് കിംഗ്ഡം	యుణైఱ్ఱడ్ కింగ్డం
ഗ്രനേഡ	గ్రనేడ
ജോർജ്ജിയ	జేాർజ్జియ
ഫ്രഞ്ച് ഗയാന	ఫ్రఞ్చ్ గయాన
ഗേൺസി	గేൺసి
ഘാന	ఘాన
ജിബ്രാൾട്ടർ	జిబ్రాൾట్టർ
ഗ്രീൻലാൻറ്	గ్రీൻలాൻఱ్
ഗാംബിയ	గాంబియ
ഗിനിയ	గినియ
ഗ്വാഡലൂപ്പ്	గ్వాడలూప్ప్
ഇക്വറ്റോറിയൽ ഗിനിയ	ఇక్వఱ్ఱేాఱియൽ గినియ
ഗ്രീസ്	గ్రీస్
ദക്ഷിണ ജോർജ്ജിയയും ദക്ഷിണ സാൻഡ്‌വിച്ച് ദ്വീപുകളും	దక్షిణ జేాർజ్జియయుం దక్షిణ సాൻడ్‌విచ్చ్ ద్వీపుకళుం
ഗ്വാട്ടിമാല	గ్వాట్టిమాల
ഗ്വാം	గ్వాం
ഗിനിയ-ബിസൗ	గినియ-బిసౌ
ഗയാന	గయాన
ഹോങ്കോങ്ങ് (SAR) ചൈന	హేాఙ్కేాఙ్ఙ్ (SAR) చైన
ഹോങ്കോങ്ങ്	హేాఙ్కేాఙ్ఙ్
ഹിയേർഡും മക്‌ഡൊണാൾഡ് ദ്വീപുകളും	హియేർడుం మక్‌డెాణాൾడ్ ద్వీపుకళుం
ഹോണ്ടുറാസ്	హేాణ్టుఱాస్
ക്രൊയേഷ്യ	క్రెాయేష్య
ഹെയ്തി	హెయ్తి
ഹംഗറി	హంగఱి
കാനറി ദ്വീപുകൾ	కానఱి ద్వీపుకൾ
ഇന്തോനേഷ്യ	ఇన్తేానేష్య
അയർലാൻഡ്	అయർలాൻడ్
ഇസ്രായേൽ	ఇస్రాయేൽ
ഐൽ ഓഫ് മാൻ	ఐൽ ఓఫ్ మాൻ
ഇന്ത്യ	ఇన్త్య
ബ്രിട്ടീഷ് ഇന്ത്യൻ മഹാസമുദ്ര പ്രദേശം	బ్రిట్టీష్ ఇన్త్యൻ మహాసముద్ర ప్రదేశం
ഇറാഖ്	ఇఱాఖ్
ഇറാൻ	ఇఱాൻ
ഐസ്‌ലാന്റ്	ఐస్‌లాన్ఱ్
ഇറ്റലി	ఇఱ్ఱలి
ജേഴ്സി	జేళ్సి
ജമൈക്ക	జమైక్క
ജോർദ്ദാൻ	జేాർద్దాൻ
ജപ്പാൻ	జప్పాൻ
കെനിയ	కెనియ
കിർഗിസ്ഥാൻ	కిർగిస్థాൻ
കംബോഡിയ	కంబేాడియ
കിരിബാട്ടി	కిరిబాట్టి
കോമൊറോസ്	కేామెాఱేాస్
സെന്റ് കിറ്റ്‌സും നെവിസും	సెన్ఱ్ కిఱ్ఱ్‌సుం నెవిసుం
ഉത്തരകൊറിയ	ఉత్తరకెాఱియ
ദക്ഷിണകൊറിയ	దక్షిణకెాఱియ
കുവൈറ്റ്	కువైఱ్ఱ్
കേമാൻ ദ്വീപുകൾ	కేమాൻ ద్వీపుకൾ
കസാഖിസ്ഥാൻ	కసాఖిస్థాൻ
ലാവോസ്	లావేాస్
ലെബനൻ	లెబనൻ
സെൻറ് ലൂസിയ	సెൻఱ్ లూసియ
ലിച്ചൺസ്റ്റൈൻ	లిచ్చൺస్ఱ్ఱైൻ
ശ്രീലങ്ക	శ్రీలఙ్క
ലൈബീരിയ	లైబీరియ
ലെസോതോ	లెసేాతేా
ലിത്വാനിയ	లిత్వానియ
ലക്സംബർഗ്	లక్సంబർగ్
ലാറ്റ്വിയ	లాఱ్ఱ్వియ
ലിബിയ	లిబియ
മൊറോക്കൊ	మెాఱేాక్కెా
മൊണാക്കോ	మెాణాక్కేా
മൾഡോവ	మൾడేావ
മോണ്ടെനെഗ്രോ	మేాణ్టెనెగ్రేా
സെൻറ് മാർട്ടിൻ	సెൻఱ్ మాർట్టిൻ
മഡഗാസ്കർ	మడగాస్కർ
മാർഷൽ‍‍ ദ്വീപുകൾ	మాർషൽ‍‍ ద్వీపుకൾ
മാസിഡോണിയ	మాసిడేాణియ
മാസിഡോണിയ (FYROM)	మాసిడేాణియ (FYROM)
മാലി	మాలి
മ്യാൻമാർ (ബർമ്മ)	మ్యాൻమాർ (బർమ్మ)
മംഗോളിയ	మంగేాళియ
മക്കാവു (SAR) ചൈന	మక్కావు (SAR) చైన
മക്കാവു	మక్కావు
ഉത്തര മറിയാനാ ദ്വീപുകൾ	ఉత్తర మఱియానా ద్వీపుకൾ
മാർട്ടിനിക്ക്	మాർట్టినిక్క్
മൗറിറ്റാനിയ	మౌఱిఱ్ఱానియ
മൊണ്ടെസരത്ത്	మెాణ్టెసరత్త్
മാൾട്ട	మాൾట్ట
മൗറീഷ്യസ്	మౌఱీష్యస్
മാലിദ്വീപ്	మాలిద్వీప్
മലാവി	మలావి
മെക്സിക്കോ	మెక్సిక్కేా
മലേഷ്യ	మలేష్య
മൊസാംബിക്ക്	మెాసాంబిక్క్
നമീബിയ	నమీబియ
പുതിയ കാലിഡോണിയ	పుతియ కాలిడేాణియ
നൈജർ	నైజർ
നോർഫോക് ദ്വീപ്	నేాർఫేాక్ ద్వీప్
നൈജീരിയ	నైజీరియ
നിക്കരാഗ്വ	నిక్కరాగ్వ
നെതർലാൻഡ്‌സ്	నెతർలాൻడ్‌స్
നോർവെ	నేాർవె
നേപ്പാൾ	నేప్పాൾ
നൗറു	నౌఱు
ന്യൂയി	న్యూయి
ന്യൂസിലാൻറ്	న్యూసిలాൻఱ్
ഒമാൻ	ఒమాൻ
പനാമ	పనామ
പെറു	పెఱు
ഫ്രഞ്ച് പോളിനേഷ്യ	ఫ్రఞ్చ్ పేాళినేష్య
പാപ്പുവ ന്യൂ ഗിനിയ	పాప్పువ న్యూ గినియ
ഫിലിപ്പൈൻസ്	ఫిలిప్పైൻస్
പാക്കിസ്ഥാൻ	పాక్కిస్థాൻ
പോളണ്ട്	పేాళణ్ట్
സെന്റ് പിയറിയും മിക്കലണും	సెన్ఱ్ పియఱియుం మిక్కలణుం
പിറ്റ്‌കെയ്‌ൻ ദ്വീപുകൾ	పిఱ్ఱ్‌కెయ్‌ൻ ద్వీపుకൾ
പ്യൂർട്ടോ റിക്കോ	ప్యూർట్టేా ఱిక్కేా
പാലസ്‌തീൻ പ്രദേശങ്ങൾ	పాలస్‌తీൻ ప్రదేశఙ్ఙൾ
പലസ്‌തീൻ	పలస్‌తీൻ
പോർച്ചുഗൽ	పేాർచ్చుగൽ
പലാവു	పలావు
പരാഗ്വേ	పరాగ్వే
ഖത്തർ	ఖత్తർ
ദ്വീപസമൂഹം	ద్వీపసమూహం
റീയൂണിയൻ	ఱీయూణియൻ
റൊമാനിയ	ఱెామానియ
സെർബിയ	సెർబియ
റഷ്യ	ఱష్య
റുവാണ്ട	ఱువాణ్ట
സൗദി അറേബ്യ	సౌది అఱేబ్య
സോളമൻ‍ ദ്വീപുകൾ	సేాళమൻ‍ ద్వీపుకൾ
സെയ്‌ഷെൽസ്	సెయ్‌షెൽస్
സുഡാൻ	సుడాൻ
സ്വീഡൻ	స్వీడൻ
സിംഗപ്പുർ	సింగప్పుർ
സെൻറ് ഹെലീന	సెൻఱ్ హెలీన
സ്ലോവേനിയ	స్లేావేనియ
സ്വാൽബാഡും ജാൻ മായേനും	స్వాൽబాడుం జాൻ మాయేనుం
സ്ലോവാക്യ	స్లేావాక్య
സിയെറ ലിയോൺ	సియెఱ లియేాൺ
സാൻ മറിനോ	సాൻ మఱినేా
സെനഗൽ	సెనగൽ
സോമാലിയ	సేామాలియ
സുരിനെയിം	సురినెయిం
ദക്ഷിണ സുഡാൻ	దక్షిణ సుడాൻ
സാവോ ടോമും പ്രിൻസിപെയും	సావేా టేాముం ప్రిൻసిపెయుం
എൽ സാൽവദോർ	ఎൽ సాൽవదేాർ
സിന്റ് മാർട്ടെൻ	సిన్ఱ్ మాർట్టెൻ
സിറിയ	సిఱియ
സ്വാസിലാൻറ്	స్వాసిలాൻఱ్
ട്രസ്റ്റൻ ഡ കൂന	ట్రస్ఱ్ఱൻ డ కూన
ടർക്ക്‌സും കെയ്‌ക്കോ ദ്വീപുകളും	టർక్క్‌సుం కెయ్‌క్కేా ద్వీపుకళుం
ഛാഡ്	ఛాడ్
ഫ്രഞ്ച് ദക്ഷിണ ഭൂപ്രദേശം	ఫ్రఞ్చ్ దక్షిణ భూప్రదేశం
ടോഗോ	టేాగేా
തായ്‌ലാൻഡ്	తాయ్‌లాൻడ్
താജിക്കിസ്ഥാൻ	తాజిక్కిస్థాൻ
ടോക്കെലൂ	టేాక్కెలూ
തിമോർ-ലെസ്റ്റെ	తిమేాർ-లెస్ఱ్ఱె
കിഴക്കൻ തിമോർ	కిళక్కൻ తిమేాർ
തുർക്ക്മെനിസ്ഥാൻ	తుർక్క్మెనిస్థాൻ
ടുണീഷ്യ	టుణీష్య
ടോംഗ	టేాంగ
തുർക്കി	తుർక్కి
ട്രിനിഡാഡും ടുബാഗോയും	ట్రినిడాడుం టుబాగేాయుం
ടുവാലു	టువాలు
തായ്‌വാൻ	తాయ్‌వాൻ
ടാൻസാനിയ	టాൻసానియ
ഉക്രെയ്‌ൻ	ఉక్రెయ్‌ൻ
ഉഗാണ്ട	ఉగాణ్ట
അമേരിക്കൻ ഐക്യനാടുകൾ	అమేరిక్కൻ ఐక్యనాటుకൾ
ഉറുഗ്വേ	ఉఱుగ్వే
ഉസ്‌ബെക്കിസ്ഥാൻ	ఉస్‌బెక్కిస్థాൻ
വത്തിക്കാൻ	వత్తిక్కాൻ
സെന്റ് വിൻസെന്റും ഗ്രനെഡൈൻസും	సెన్ఱ్ విൻసెన్ఱుం గ్రనెడైൻసుం
വെനിസ്വേല	వెనిస్వేల
ബ്രിട്ടീഷ് വെർജിൻ ദ്വീപുകൾ	బ్రిట్టీష్ వెർజిൻ ద్వీపుకൾ
വിയറ്റ്നാം	వియఱ్ఱ్నాం
വന്വാതു	వన్వాతు
വാലിസ് ആന്റ് ഫ്യൂച്യുന	వాలిస్ ఆన్ఱ్ ఫ్యూచ్యున
സമോവ	సమేావ
കൊസോവൊ	కెాసేావెా
യെമൻ	యెమൻ
മയോട്ടി	మయేాట్టి
ദക്ഷിണാഫ്രിക്ക	దక్షిణాఫ్రిక్క
സാംബിയ	సాంబియ
സിംബാബ്‌വേ	సింబాబ్‌వే
അജ്ഞാത പ്രദേശം	అజ్ఞాత ప్రదేశం
