# Baby names
അകര്ശാനാ	अकर्शाना
അക്ശൈനീഏ	अक्शैनीए
അഗജാ	अगजा
അചിംത	अचिंत
അചിത	अचित
അച്ചിന്ദ്ര	अच्चिन्द्र
അഡ്യാദവൈതാ	अड्यादवैता
അദഭുതഃ	अदभुतः
അദേന്യ	अदेन्य
അദേല	अदेल
അദ്രിതീ	अद्रिती
അദ്രീഥീ	अद्रीथी
അദ്രീമാം	अद्रीमां
അദ്വൈയാ	अद्वैया
അധര്ഷ	अधर्ष
അധിപാ	अधिपा
അധീരതാ	अधीरता
അധ്യുത	अध्युत
അനംതാമായാ	अनंतामाया
അബരനാ	अबरना
അബിനയ	अबिनय
അബിനാ	अबिना
അബീനംദാ	अबीनंदा
അബീശാ	अबीशा
അഭയ	अभय
അഭയന	अभयन
അഭിഗ്ന്യാ	अभिग्न्या
അഭിജീതാ	अभिजीता
അഭിനിവേശ	अभिनिवेश
അഭിമ	अभिम
അഭിമാനീ	अभिमानी
അഭിമോദാ	अभिमेादा
അഭിരാ	अभिरा
അഭിരാത	अभिरात
അഭീരല	अभीरल
അഭീശ്രേയ	अभीश्रेय
അഭീസുമത	अभीसुमत
അഭ്യപ്സീത	अभ्यप्सीत
അഭ്യുദയാ	अभ्युदया
അമൃതാ	अमृता
അലകനംദാ	अलकनंदा
അലക്ഷാ	अलक्षा
അല്കാ	अल्का
അശവ	अशव
അശ്നേഇല	अश्नेइल
ആകാശലീനാ	आकाशलीना
ആകൃഥീ	आकृथी
ആക്ഷ്യാ	आक्ष्या
ആചാര്യ	आचार्य
ആത്മയ	आत्मय
ആദി	आदि
ആദിമ	आदिम
ആദീവ	आदीव
ആധീരേന	आधीरेन
ആധ്യാ	आध्या
ആനംദീനീ	आनंदीनी
ആനീകാ	आनीका
ആന്തീകാ	आन्तीका
ആന്വീ	आन्वी
ആപ്ത	आप्त
ആപ്തി	आप्ति
ആമാംനീ	आमांनी
ആമിഷ	आमिष
ആമുക്ഥാ	आमुक्था
ആയുസ	आयुस
ആയോദ	आयेाद
ആരംഭീ	आरंभी
ആരതീ	आरती
ആരസീ	आरसी
ആര്യ	आर्य
ആര്യക	आर्यक
ആര്യനാ	आर्यना
ആര്യമാനീ	आर्यमानी
ആലേഃയാ	आलेःया
ആവംശ	आवंश
ആവേശ	आवेश
ആശകാ	आशका
ആശിയാനാ	आशियाना
ആശുതോഷ	आशुतेाष
ആശ്മീന	आश्मीन
ആശ്വിത	आश्वित
ആസവ	आसव
ആസ്തിക	आस्तिक
ഇക്ശാനാ	इक्शाना
ഇജയാ	इजया
ഇനീയന	इनीयन
ഇനോദയ	इनेादय
ഇന്ദരകാന്ത	इन्दरकान्त
ഇന്ദിവാരസ	इन्दिवारस
ഇന്ദുശിതാലാ	इन्दुशिताला
ഇന്ദ്രജാ	इन्द्रजा
ഇന്ദ്രതന	इन्द्रतन
ഇന്ദ്രദയുമ്ന	इन्द्रदयुम्न
ഇന്ദ്രവദന	इन्द्रवदन
ഇന്ദ്രാണീ	इन्द्राणी
ഇബ്ബാനീ	इब्बानी
ഇയുരേശ	इयुरेश
ഇയേനഗര	इयेनगर
ഇരാജ	इराज
ഇരിത	इरित
ഇരേശ	इरेश
ഇലിസാ	इलिसा
ഇശിതാ	इशिता
ഇശ്വാര്യ	इश्वार्य
ഇഷ്ടാ	इष्टा
ഇഷ്ടി	इष्टि
ഇസാര	इसार
ഇസ്ശും	इस्शुं
ഈതന	ईतन
ഈതികാ	ईतिका
ഈരേന്പ്രിത	ईरेन्प्रित
ഈര്ശീതാ	ईर्शीता
ഈലാക്കീയാ	ईलाक्कीया
ഈലികാ	ईलिका
ഈലേശാ	ईलेशा
ഈശാര	ईशार
ഈശിക	ईशिक
ഈശ്വരദത്ത	ईश्वरदत्त
ഈഹാ	ईहा
ഉഗ്രസ്രവാസ	उग्रस्रवास
ഉജവണീ	उजवणी
ഉജേശാ	उजेशा
ഉജ്ജന	उज्जन
ഉജ്ജവല	उज्जवल
ഉജ്ജവാലാ	उज्जवाला
ഉജ്ജ്വലാ /ഉജ്വലാ	उज्ज्वला /उज्वला
ഉജ്ജ്വാലാ	उज्ज्वाला
ഉത്കര്ഷ	उत्कर्ष
ഉത്കലാ	उत्कला
ഉത്തര	उत्तर
ഉത്പര	उत्पर
ഉത്സര്ഗ	उत्सर्ग
ഉദയ കുമാര	उदय कुमार
ഉദരഥീ	उदरथी
ഉദാന്തികാ	उदान्तिका
ഉദേയ	उदेय
ഉദ്ധാര	उद्धार
ഉദ്യത	उद्यत
ഉദ്യമീ	उद्यमी
ഉദ്യോത	उद्येात
ഉധവ	उधव
ഉപംഗ	उपंग
ഉപദാ	उपदा
ഉപാധ്രീതീ	उपाध्रीती
ഉപ്പാസ	उप्पास
ഉമാ	उमा
ഉമേശ്വര	उमेश्वर
ഉരിശിതാ	उरिशिता
ഉര്ജാ	उर्जा
ഉര്ജീകാ	उर्जीका
ഉര്ജീതാ	उर्जीता
ഉര്ദാഹാവ	उर्दाहाव
ഉര്മികാ	उर्मिका
ഉര്മിമാലാ	उर्मिमाला
ഉര്വീനാഥ	उर्वीनाथ
ഉല്പേശ	उल्पेश
ഉശേന്യ	उशेन्य
ഉഷാശി	उषाशि
ഉഷ്മാ	उष्मा
ഉസരീ	उसरी
ഊതരാ	ऊतरा
ഊര്വേശ	ऊर्वेश
ഏകംശീ	एकंशी
ഏകക്ഷരപരാ	एकक्षरपरा
ഏകതന	एकतन
ഏകതാ	एकता
ഏകാംശ	एकांश
ഏകാകാന്യ	एकाकान्य
ഏകാനീ	एकानी
ഏകാപര്നികാ	एकापर्निका
ഏകേസ്വാര	एकेस्वार
ഏത്തന	एत्तन
ഏധിത	एधित
ഏമാ	एमा
ഏലനാ	एलना
ഏലാ	एला
ഏലീലവേംദന	एलीलवेंदन
ഏലീലീ	एलीली
ഓഈസീന	ओईसीन
ഓജസ്വീ	ओजस्वी
ഓജാ	ओजा
ഓജീസ	ओजीस
ഓനിശ	ओनिश
ഓമപ്രകാശ	ओमप्रकाश
ഓവീന	ओवीन
ഓവൈസ	ओवैस
കംജ	कंज
കംജന	कंजन
കംഠന	कंठन
കംദര്പ	कंदर्प
കംപനാ	कंपना
കകോന	ककेान
കതകീ	कतकी
കതേല്യ്ന	कतेल्य्न
കനക	कनक
കനദ	कनद
കനാകംഗീ	कनाकंगी
കനീജാ	कनीजा
കനീരാ	कनीरा
കനീസാ	कनीसा
കനുഷ	कनुष
കന്വക	कन्वक
കന്ശീകാ	कन्शीका
കപാലീന	कपालीन
കപിലാശ്വര	कपिलाश्वर
കമലാപതി	कमलापति
കമലിനീ	कमलिनी
കമലേക്ഷണ	कमलेक्षण
കമ്നാ	कम्ना
കരാലാ	कराला
കരീസമാം	करीसमां
കരുനാസ്രീ	करुनास्री
കരുപ്പസമ്യ	करुप्पसम्य
കര്ണ	कर्ण
കര്തീഗാ	कर्तीगा
കര്മദീപ	कर्मदीप
കര്മാശ	कर्माश
കലരനീ	कलरनी
കലശ	कलश
കലാധര	कलाधर
കലാനിധി	कलानिधि
കലാപരണ	कलापरण
കലാപീന	कलापीन
കലാപ്രിയാ	कलाप्रिया
കലൈസേലവീ	कलैसेलवी
കവന	कवन
കവിപ  പ്രിയ	कविप  प्रिय
കവീനാഥ	कवीनाथ
കശ്തീ	कश्ती
കാജല	काजल
കാജീശ	काजीश
കാദമ്ബരീ	कादम्बरी
കാധിരോലീ	काधिरेाली
കാനീ	कानी
കാന്ജീരാ	कान्जीरा
കാന്തീ	कान्ती
കാമത	कामत
കാമിഷാ	कामिषा
കാമേശ	कामेश
കാരുണ്യ പ്രകാശ	कारुण्य प्रकाश
കാരൂകാ	कारूका
കാര്നിക	कार्निक
കാലിക	कालिक
കാലിപദാ	कालिपदा
കാലിയാ	कालिया
കാലീതാ	कालीता
കാവ്യ ശ്രീ	काव्य श्री
കിന്നേരാ	किन्नेरा
കീഅനാ	कीअना
കീജല	कीजल
കീനാരീ	कीनारी
കീന്ചനാ	कीन्चना
കേകലാ	केकला
കേതന	केतन
കേനിഷാ	केनिषा
കേളവ്യ	केळव्य
കൈരവീ	कैरवी
കൈലാശ	कैलाश
കോശേല	केाशेल
കൌശികാ	कॆशिका
ഖഗേശ	खगेश
ഖമീശ	खमीश
ഖാതീരാവണ	खातीरावण
ഖാത്വന്ഗീന	खात्वन्गीन
ഖീലതീ	खीलती
ഖുസീ	खुसी
ഗംഗാ	गंगा
ഗംദേശാ	गंदेशा
ഗംധാര	गंधार
ഗംധാരാ	गंधारा
ഗംധാലീ	गंधाली
ഗഗന	गगन
ഗജവദന	गजवदन
ഗജേന്ദ്ര	गजेन्द्र
ഗണക	गणक
ഗണനാ പംഡിതന	गणना पंडितन
ഗണനാഥ	गणनाथ
ഗണ്യാ	गण्या
ഗതി	गति
ഗനേസന	गनेसन
ഗന്ഗസീരുവന	गन्गसीरुवन
ഗയാലികാ	गयालिका
ഗരിമാ	गरिमा
ഗരിഷ്ട	गरिष्ट
ഗരുല	गरुल
ഗാഇശ	गाइश
ഗാന്ഗമൈന്ദന	गान्गमैन्दन
ഗാമിനീ	गामिनी
ഗായത്രീ	गायत्री
ഗായലേ	गायले
ഗിഅന	गिअन
ഗിയാ	गिया
ഗിരിവര	गिरिवर
ഗീതി	गीति
ഗീതീശാ	गीतीशा
ഗുംജാ	गुंजा
ഗുനാജാ	गुनाजा
ഗുനാരത്നാ	गुनारत्ना
ഗുനാശേകാര	गुनाशेकार
ഗുനീന	गुनीन
ഗുന്ജീതാ	गुन्जीता
ഗുപ്തക	गुप्तक
ഗുരദയാല	गुरदयाल
ഗുരദേവ	गुरदेव
ഗുരബാനീ	गुरबानी
ഗുരമാന	गुरमान
ഗുരുത്തമ	गुरुत्तम
ഗുര്നാന്ഡീശ	गुर्नान्डीश
ഗുലമോഹര	गुलमेाहर
ഗുവീദ	गुवीद
ഗൂംജീതാ	गूंजीता
ഗൂഹാരീ	गूहारी
ഗേനേലിയാ	गेनेलिया
ഗേശനാ	गेशना
ഗോപാല	गेापाल
ഗോപീ നാഥ	गेापी नाथ
ഗോഭില	गेाभिल
ഗോരഖ-നാഥ	गेारख-नाथ
ഗൌരവീ	गॆरवी
ഗൌരീകാംത	गॆरीकांत
ഗൌരീശ	गॆरीश
ഗൌര്പ്രിയാ	गॆर्प्रिया
ഗ്രീതേശ	ग्रीतेश
ഗ്രീവാ	ग्रीवा
ഗ്രീശ്മീതാ	ग्रीश्मीता
ഗ്രീഷ്മ	ग्रीष्म
ഘടോതകത്ചാ	घटेातकत्चा
ചംചലാ	चंचला
ചംദേര്ഭാന	चंदेर्भान
ചംദ്രകാംത	चंद्रकांत
ചംദ്രകാംതാ	चंद्रकांता
ചംദ്രചുര	चंद्रचुर
ചംദ്രപുശ്പാ	चंद्रपुश्पा
ചംദ്രപ്രകാശ	चंद्रप्रकाश
ചംദ്രമതി	चंद्रमति
ചംദ്രലേഖാ	चंद्रलेखा
ചംദ്രഹാസ	चंद्रहास
ചംദ്രാനന	चंद्रानन
ചംദ്രാഭാ	चंद्राभा
ചംദ്രേശ	चंद्रेश
ചകേശ	चकेश
ചകോര	चकेार
ചക്ഷസ	चक्षस
ചതുര	चतुर
ചതുരാ	चतुरा
ചതുര്ഭുജാ	चतुर्भुजा
ചതുര്വേദീ	चतुर्वेदी
ചത്രീയാ	चत्रीया
ചന്ദ്രകേതു	चन्द्रकेतु
ചരണ	चरण
ചരന്യാ	चरन्या
ചലാമാ	चलामा
ചാംദ	चांद
ചാനാസ്യാ	चानास्या
ചാനേ	चाने
ചാന്ദനികാ	चान्दनिका
ചാരുന	चारुन
ചാരുവീ	चारुवी
ചാര്മീ	चार्मी
ചാര്വീ	चार्वी
ചാവ്രിക	चाव्रिक
ചിത്കലാ	चित्कला
ചിത്ത	चित्त
ചിത്തപ്രസാദ	चित्तप्रसाद
ചിത്തരംജന	चित्तरंजन
ചിത്തരംജനീ	चित्तरंजनी
ചിത്രകുന്ധാലാ	चित्रकुन्धाला
ചിത്രകേതു	चित्रकेतु
ചിത്രഗംധാ	चित्रगंधा
ചിത്രബാനാ	चित्रबाना
ചിത്രമാലാ	चित्रमाला
ചിത്രര്ത	चित्रर्त
ചിത്രല	चित्रल
ചിത്രലേഖാ	चित्रलेखा
ചിത്രാദീപ	चित्रादीप
ചിത്രീനീ	चित्रीनी
ചിദംബര	चिदंबर
ചിദാനംദാ	चिदानंदा
ചിനാര	चिनार
ചിന്നാദുരാഈ	चिन्नादुराई
ചിമന	चिमन
ചീദാര്ത	चीदार्त
ചീന്മയേ	चीन्मये
ചീരുഷ	चीरुष
ചേതന്ദീപ	चेतन्दीप
ചേതള	चेतळ
ചേഥാസാ	चेथासा
ചേമ്മല	चेम्मल
ചേര്വിക	चेर्विक
ചേലന	चेलन
ചേലിയാഁ	चेलियाഁ
ചൈതന്യാ	चैतन्या
ചൈത്രാ	चैत्रा
ചൈരാവലീ	चैरावली
ഛായാംക	छायांक
ജക്ഷ	जक्ष
ജക്ഷാനീ	जक्षानी
ജഗതപ്രകാശ	जगतप्रकाश
ജഗദഗുരു	जगदगुरु
ജഗദമ്ബാ	जगदम्बा
ജഗനമോഹിനീ	जगनमेाहिनी
ജഗന്മയീ	जगन्मयी
ജഗ്വീ	जग्वी
ജഗ്വീര	जग्वीर
ജജ്വാല്യാ	जज्वाल्या
ജടായു	जटायु
ജനഹിതാ	जनहिता
ജനാദേവ	जनादेव
ജനാവ	जनाव
ജനിത	जनित
ജമാംദാഗ്ന്യ മഹാദാര്പാ	जमांदाग्न्य महादार्पा
ജമ്ബവതപ്രീതി	जम्बवतप्रीति
ജയംത	जयंत
ജയചംദ	जयचंद
ജയപാല	जयपाल
ജയമാലാ	जयमाला
ജയശ്രീ	जयश्री
ജയാകീര്തന	जयाकीर्तन
ജയാകേതന	जयाकेतन
ജയാപാദമാം	जयापादमां
ജയായ	जयाय
ജയിത	जयित
ജയേശ	जयेश
ജലദ	जलद
ജല്പേശ	जल्पेश
ജശവംത	जशवंत
ജസീത്താ	जसीत्ता
ജസ്സീ	जस्सी
ജാനകീ	जानकी
ജാനകീദാസ	जानकीदास
ജാനകീനാഥ	जानकीनाथ
ജാനകീഭൂഷണ	जानकीभूषण
ജാനഹിതാ	जानहिता
ജാപക	जापक
ജായിത്രീ	जायित्री
ജിനേശ്വര	जिनेश्वर
ജിഹാന	जिहान
ജീതേശ	जीतेश
ജീന്ദാല	जीन्दाल
ജീവനകലാ	जीवनकला
ജീവനീ	जीवनी
ജീവന്തീനീ	जीवन्तीनी
ജുഷ്ടി	जुष्टि
ജേനീശാ	जेनीशा
ജേര്ശീകാ	जेर्शीका
ജൈകാപിശ	जैकापिश
ജൈചരണ	जैचरण
ജൈനീശ	जैनीश
ജൈപ്രകാശ	जैप्रकाश
ജൈവംത	जैवंत
ജൈസല	जैसल
ജൈഹാസീനീ	जैहासीनी
ജോംഫീ	जेांफी
ജോശനീകാ	जेाशनीका
ജോശീതാ	जेाशीता
ജ്വാലാ	ज्वाला
ജ്ഹില	ज्हिल
ജ്ഹീണൂക	ज्हीणूक
ഝഹനവീ	झहनवी
ഝാനീശാ	झानीशा
ഝാരാ	झारा
ഝീയാ	झीया
ഝേനീശാ	झेनीशा
ഝ്യാനനീ	झ्याननी
ടീംകു	टींकु
ഠുമരീ	ठुमरी
തക്ശീ	तक्शी
തക്ശീല	तक्शील
തജജ്ഞ	तजज्ञ
തനവീ	तनवी
തനിഷ്ക	तनिष्क
തനുംജാശ്രീ	तनुंजाश्री
തനുംശ്കാ	तनुंश्का
തനോജ	तनेाज
തപസ	तपस
തപസ്വിനീ	तपस्विनी
തമില  സേല്വീ	तमिल  सेल्वी
തമിശ	तमिश
തമോഘ്നാ	तमेाघ्ना
തമോനഷ	तमेानष
തരംജോത	तरंजेात
തരനീ	तरनी
തരലാ	तरला
തരീനീ	तरीनी
തരുശ്രീ	तरुश्री
തരൂണീ	तरूणी
തവലീന :	तवलीन :
തവിഷാ	तविषा
തസ്യ	तस्य
താക്ഷ്യാ	ताक्ष्या
താജേന്ദര	ताजेन्दर
താനാരുപീ	तानारुपी
താനിയാ	तानिया
താന്വീഥാ	तान्वीथा
താപീ	तापी
താരികാ	तारिका
താരീനീ	तारीनी
താരൂശ	तारूश
താലംക	तालंक
താലീന	तालीन
താലേശ	तालेश
താവന	तावन
താവീശാ	तावीशा
തിതലീ	तितली
തിനാശ	तिनाश
തിലക	तिलक
തീഈവ്യേശ	तीईव्येश
തീര്ഥാ	तीर्था
തീസ്ചാ	तीस्चा
തുത്തീ	तुत्ती
തുനാവാ	तुनावा
തുന്ഗാര	तुन्गार
തുപമ	तुपम
തുരഗ	तुरग
തുശീഥാ	तुशीथा
തൃപേശ	तृपेश
തേജസ	तेजस
തേജസ്വീ	तेजस्वी
തേജസ്വീന	तेजस्वीन
തേജേനദര	तेजेनदर
തേജോമയ	तेजेामय
തോയേശ	तेायेश
തോശീകാ	तेाशीका
തൌരുസ	तॆरुस
ത്രികായാ	त्रिकाया
ത്രിപുരസുംദരീ	त्रिपुरसुंदरी
ത്രിഭുവന	त्रिभुवन
ത്രിമാന	त्रिमान
ത്രിമൂര്തി	त्रिमूर्ति
ത്രിവേണീ	त्रिवेणी
ത്രിശല	त्रिशल
ത്രിശലാനാ	त्रिशलाना
ത്രീഝ്യാ	त्रीझ्या
ത്രീതിയാ	त्रीतिया
ത്രീനേശ	त्रीनेश
ത്രീപന	त्रीपन
ത്രീപ്ത	त्रीप्त
ത്രീവീദ	त्रीवीद
ത്വരിതാ	त्वरिता
ത്വീശീ	त्वीशी
ത്വേസാ	त्वेसा
ഥംസീ	थंसी
ഥനീരികാ	थनीरिका
ഥാകാപ്പന്സ്വാമീ	थाकाप्पन्स्वामी
ഥാരികാ	थारिका
ഥാവനീ	थावनी
ഥീരീശ്കാ	थीरीश्का
ഥുസീഥാ	थुसीथा
ഥ്രേശാ	थ्रेशा
ദംദാപാനീ	दंदापानी
ദക്ഷാഹതാ	दक्षाहता
ദബീത	दबीत
ദബ്ന്ശും	दब्न्शुं
ദയാദാ	दयादा
ദയാനിതാ	दयानिता
ദരഹാസ	दरहास
ദര്ശ	दर्श
ദര്ശക	दर्शक
ദര്ശികാ	दर्शिका
ദര്ശീനീ	दर्शीनी
ദര്സീകാ	दर्सीका
ദശാഗ്രീവാ ശീരോഹരാ	दशाग्रीवा शीरेाहरा
ദശാഗ്രീവാകുലാന്താകാ	दशाग्रीवाकुलान्ताका
ദശാനന	दशानन
ദഹാ	दहा
ദാനാസ്വീ	दानास्वी
ദാനുംശ്രീ	दानुंश्री
ദാന്ദാകാരാന്യ പുന്യകൃതേ	दान्दाकारान्य पुन्यकृते
ദാരുല	दारुल
ദാഹക	दाहक
ദികീശംദ	दिकीशंद
ദിഗീശാ	दिगीशा
ദിപംശീ	दिपंशी
ദിപശീകീ	दिपशीकी
ദിപേംദര	दिपेंदर
ദിപ്താ	दिप्ता
ദിബസരീ	दिबसरी
ദിവീഥാ	दिवीथा
ദിവേനാ	दिवेना
ദീതാ	दीता
ദീനബംധു	दीनबंधु
ദീപഥീ	दीपथी
ദീപപ്രഭാ	दीपप्रभा
ദീപമാലാ	दीपमाला
ദീപശിഖാ	दीपशिखा
ദീപാംജലി	दीपांजलि
ദീപാശാ	दीपाशा
ദീപിത	दीपित
ദീവാംശ	दीवांश
ദേജ	देज
ദേബജ്യോതീ	देबज्येाती
ദേബദാത്താ	देबदात्ता
ദേബദ്രിതാ	देबद्रिता
ദേബന്ശീ	देबन्शी
ദേയ്വയാനാകാന്തന	देय्वयानाकान्तन
ദേവഗര്ഭാ	देवगर्भा
ദേവജ്യോതി	देवज्येाति
ദേവദാന	देवदान
ദേവന്ദ്ര	देवन्द्र
ദേവമദാനാ	देवमदाना
ദേവരാജ	देवराज
ദേവശ്രീ	देवश्री
ദേവാംഗനാ	देवांगना
ദേവാംഗീ	देवांगी
ദേവാംശു	देवांशु
ദേവാദീത്യാ	देवादीत्या
ദേവാനീ	देवानी
ദേവാന്ശാ	देवान्शा
ദേവാപ്രിയാ	देवाप्रिया
ദേവാമനോഹാരീ	देवामनेाहारी
ദേവീന	देवीन
ദേവീലാല	देवीलाल
ദേവേന	देवेन
ദേവേശീ	देवेशी
ദേവ്യഹ്നാന	देव्यह्नान
ദേശാവംത	देशावंत
ദൈത്യാകുലാന്താകാ	दैत्याकुलान्ताका
ദൈവ്യാ	दैव्या
ധക്ശീന്യ	धक्शीन्य
ധനസുഖ	धनसुख
ധനാജീ	धनाजी
ധനിഷ്ഠ	धनिष्ठ
ധനു	धनु
ധനുജാ	धनुजा
ധനേശീ	धनेशी
ധന്വികാ	धन्विका
ധരമനിഷ്ഠ	धरमनिष्ठ
ധരാമാം	धरामां
ധരാഹാസീനീ	धराहासीनी
ധരീശ	धरीश
ധര്മ  ദുത്ത	धर्म  दुत्त
ധര്മഅധ്യക്ഷ	धर्मअध्यक्ष
ധര്മദിത്യ	धर्मदित्य
ധര്മദേവ	धर्मदेव
ധര്ശീതാ	धर्शीता
ധര്ശീനീ	धर्शीनी
ധാമീനീ	धामीनी
ധാരാനീ	धारानी
ധിതി	धिति
ധിതീ	धिती
ധീപ്ത്ഹാ	धीप्त्हा
ധീമാഹീ	धीमाही
ധീര്ഥാ	धीर्था
ധേയാംശീ	धेयांशी
ധൈര്യ്യാ	धैर्य्या
ധ്യുഥീ	ध्युथी
ധ്രുമീ	ध्रुमी
നംദക	नंदक
നംദു	नंदु
നക്ശ	नक्श
നക്സത്രരാജാ	नक्सत्रराजा
നഗമാനീ	नगमानी
നടവര	नटवर
നത്രീശാ	नत्रीशा
നദീപ	नदीप
നഭാ	नभा
നഭോമാനീ	नभेामानी
നമന	नमन
നമനാ	नमना
നയന	नयन
നരേന്ദ്രന	नरेन्द्रन
നരേന്ദ്രനാഥ	नरेन्द्रनाथ
നരേശ	नरेश
നവനീത വിലീപ്തംഗാ	नवनीत विलीप्तंगा
നവമ	नवम
നവരംഗ	नवरंग
നസീബ	नसीब
നാംബീ	नांबी
നാഗനാഥ	नागनाथ
നാഗപാല	नागपाल
നാഗേശ്വരണ	नागेश्वरण
നാഗൈഃ	नागैः
നാതാഭൈരവീ	नाताभैरवी
നാതിന	नातिन
നാന്ധീനീ	नान्धीनी
നാന്നാന	नान्नान
നാഭിതാ	नाभिता
നാഭേംദു	नाभेंदु
നാമത	नामत
നായകീ	नायकी
നായാനീ	नायानी
നായാനീകാ	नायानीका
നാലിനികാംത	नालिनिकांत
നാലീനേശയ	नालीनेशय
നാവീന്യ	नावीन्य
നാവീല	नावील
നാവ്യാ ദുര്ഗാ	नाव्या दुर्गा
നാവ്രീതാ	नाव्रीता
നികാരാ	निकारा
നിഖിതാ	निखिता
നിഖില	निखिल
നിജു	निजु
നിധി	निधि
നിധിപാ	निधिपा
നിപാ	निपा
നിരംജനാ	निरंजना
നിരമഈ	निरमई
നിരുപമാ	निरुपमा
നിര്മളാ	निर्मळा
നിര്മിതി	निर्मिति
നിലാശാ	निलाशा
നിശാനഥീ	निशानथी
നീഗീഥാ	नीगीथा
നീതു	नीतु
നീഥീകാ	नीथीका
നീധാ	नीधा
നീധാര്സനാ	नीधार्सना
നീമാംലന	नीमांलन
നീരാലികാ	नीरालिका
നീരൈമാംഥീ	नीरैमांथी
നീര്മുകതാ	नीर्मुकता
നീല മാധവ	नील माधव
നീലംജന	नीलंजन
നീലക്ഷ	नीलक्ष
നീല്ജാ	नील्जा
നീശാലീ	नीशाली
നീശീതീ	नीशीती
നീശ്മീഥാ	नीश्मीथा
നീസ്ചീഥാ	नीस्चीथा
നീഹാ	नीहा
നേമീശാ	नेमीशा
നേയ്സാ	नेय्सा
നേരീശാ	नेरीशा
നൈജാ	नैजा
നൈരീതീ	नैरीती
നൈവേധീ	नैवेधी
നൌസദ	नॆसद
പംകജന	पंकजन
പംചഭൂതാത്മികാ	पंचभूतात्मिका
പംഥീനീ	पंथीनी
പഝ്ഹേനീ	पझ्हेनी
പത്താമ്ബരാപരീധാനാ	पत्ताम्बरापरीधाना
പത്ര	पत्र
പന്ദാലാവാസന	पन्दालावासन
പമ്പാ	पम्पा
പമ്ഫാ	पम्फा
പയാസ	पयास
പയോധീ	पयेाधी
പരംതാപാ	परंतापा
പരമാംത്മികാ	परमांत्मिका
പരമാംന്ത്ര	परमांन्त्र
പരമിലാ	परमिला
പരമേശ്വരീ	परमेश्वरी
പരമ്വാര്ദാന	परम्वार्दान
പരവാനീ	परवानी
പരവിംദര	परविंदर
പരാകാഷ	पराकाष
പരാവീ	परावी
പരിഹാ	परिहा
പര്തീബന	पर्तीबन
പര്ലീ	पर्ली
പര്വ	पर्व
പലാക്ഷ	पलाक्ष
പലാശീനീ	पलाशीनी
പവന	पवन
പവനസുത	पवनसुत
പശുപതി	पशुपति
പഹലാജ	पहलाज
പാടലാ	पाटला
പാന്ദുരംഗാ	पान्दुरंगा
പായല	पायल
പാരു	पारु
പാര്ഥിക	पार्थिक
പാര്ഥീവീ	पार्थीवी
പാര്ഥോ	पार्थेा
പാളവീ	पाळवी
പാവകീ	पावकी
പാവനാ	पावना
പാവാനാ	पावाना
പാഹീ	पाही
പിവാല	पिवाल
പൂജന	पूजन
പൂരതീ	पूरती
പൂരികാ	पूरिका
പൂര്വജാ	पूर्वजा
പൂര്വികാ	पूर्विका
പേഖമ	पेखम
പേത്ചീ	पेत्ची
പേരാരസീ	पेरारसी
പ്രകൃഥീ	प्रकृथी
പ്രഗന്യാ	प्रगन्या
പ്രഗ്യപരാമിതാ	प्रग्यपरामिता
പ്രജാനാ	प्रजाना
പ്രനാദാ	प्रनादा
പ്രനീധാനാ	प्रनीधाना
പ്രബകരണ	प्रबकरण
പ്രഭാകര	प्रभाकर
പ്രഭാകരന	प्रभाकरन
പ്രഭാത	प्रभात
പ്രഭാവ	प्रभाव
പ്രാതീകാ	प्रातीका
ഫനീ	फनी
ഫനീഭുഷണ	फनीभुषण
ഫാല്ഗുനീ	फाल्गुनी
ഫൂലന	फूलन
ഫ്രാന്ചീസ	फ्रान्चीस
ബംദിശ	बंदिश
ബംധൂല	बंधूल
ബംശീ	बंशी
ബംസീധര	बंसीधर
ബകുലാ	बकुला
ബകൂല	बकूल
ബദ്രീ	बद्री
ബനജ	बनज
ബനവാരീ	बनवारी
ബബന	बबन
ബബിശ	बबिश
ബര്ഹന	बर्हन
ബലബീര	बलबीर
ബഹവാസ്യ	बहवास्य
ബാബു	बाबु
ബാബുല	बाबुल
ബാല മുകുന്ദ	बाल मुकुन्द
ബാലധി	बालधि
ബാലാമോഹന	बालामेाहन
ബാലാരാജ	बालाराज
ബാലാശംകര	बालाशंकर
ബാലു	बालु
ബാലേന്ദു	बालेन्दु
ബാസ്കാര	बास्कार
ബിനീതാ	बिनीता
ബീനും	बीनुं
ബീന്ദുശ്രീ	बीन्दुश्री
ബീന്നീകേര	बीन्नीकेर
ബീപുല	बीपुल
ബീബീന	बीबीन
ബീരത	बीरत
ബീഹാന	बीहान
ബേനീതാ	बेनीता
ബേനും	बेनुं
ബേലുരമീ	बेलुरमी
ബേല്ലീ	बेल्ली
ബൈവാവീ	बैवावी
ബൈസാഖീ	बैसाखी
ബ്രീഥ്ഹീ	ब्रीथ्ही
ബ്ലേസ്സീ	ब्लेस्सी
ഭഗവാന	भगवान
ഭദ്രക്ഷ	भद्रक्ष
ഭദ്രനിധി	भद्रनिधि
ഭദ്രപ്രിയാ	भद्रप्रिया
ഭദ്രിക	भद्रिक
ഭദ്രീശാ	भद्रीशा
ഭവാനീ	भवानी
ഭവ്യരാജ	भव्यराज
ഭാഗവംതീ	भागवंती
ഭാദരന	भादरन
ഭാനുമിത്ര	भानुमित्र
ഭാരഥീ	भारथी
ഭാര്ഗവന	भार्गवन
ഭാര്ഗവാ	भार्गवा
ഭാര്ഘവീ	भार्घवी
ഭാര്ദ്ദ്വാജ	भार्द्द्वाज
ഭാലേംദ്ര	भालेंद्र
ഭാവതീ	भावती
ഭാവീഗുരും	भावीगुरुं
ഭാവ്യമ	भाव्यम
ഭാശ്വീനീ	भाश्वीनी
ഭാസു	भासु
ഭാസ്കാരീ	भास्कारी
ഭാസ്കേര	भास्केर
ഭീമശംകര	भीमशंकर
ഭൂദേവ	भूदेव
ഭൂപത	भूपत
ഭൂപാല	भूपाल
ഭൂമാ	भूमा
ഭൂമാം	भूमां
ഭേരേശ	भेरेश
ഭൈരവീ	भैरवी
മംഗലമ	मंगलम
മംഗേശ	मंगेश
മംജു  പ്രസന്ന	मंजु  प्रसन्न
മംജുനാഥ	मंजुनाथ
മംജുലാ	मंजुला
മംത	मंत
മംതോഷ	मंतेाष
മംദിഥാ	मंदिथा
മംദിരാ	मंदिरा
മകാലീ	मकाली
മകുര	मकुर
മഗന	मगन
മണികാംത	मणिकांत
മദുരാ	मदुरा
മധുനിഷാ	मधुनिषा
മധുമാംലീ	मधुमांली
മധുരിമാ	मधुरिमा
മധുവംതീ	मधुवंती
മനജീത	मनजीत
മനപ	मनप
മനസ്വിന	मनस्विन
മനാല്പ	मनाल्प
മനീതാ	मनीता
മനീഷ	मनीष
മനോജ	मनेाज
മനോരനജനീ	मनेारनजनी
മനോരിഥാ	मनेारिथा
മന്നത	मन्नत
മന്മായീ	मन्मायी
മല്ലികാ	मल्लिका
മഹംത	महंत
മഹാതപസ്വീ	महातपस्वी
മഹാദുര്ഗാ	महादुर्गा
മഹാദേവാ	महादेवा
മഹാദേവാദീപുജീതാ	महादेवादीपुजीता
മഹാന്തേശ	महान्तेश
മഹാബാലാ	महाबाला
മഹാസ്വേതാ	महास्वेता
മഹിപതി	महिपति
മഹിഷാസുരമര്ദിനീ	महिषासुरमर्दिनी
മഹീജിത	महीजित
മഹേംദ്രാ	महेंद्रा
മഹേശ	महेश
മഹേശനീ	महेशनी
മഹേശീ	महेशी
മാംതിക	मांतिक
മാംനീമോഝ്ഹീ	मांनीमेाझ्ही
മാംനുസരീ	मांनुसरी
മാംന്ക്ഷ	मांन्क्ष
മാംന്ഗീരീ	मांन्गीरी
മാംന്താവ്യാഹ	मांन्ताव्याह
മാംന്തീകാ	मांन्तीका
മാംന്ദീതാ	मांन्दीता
മാംലാമാംകാല മകാന	मांलामांकाल मकान
മാഇല	माइल
മാനകാ	मानका
മാനജ	मानज
മാനശ	मानश
മാനിക	मानिक
മാനീശീന	मानीशीन
മാനോരിത	मानेारित
മാന്കന	मान्कन
മാന്ദാവിക	मान्दाविक
മായാ	माया
മാര്ഗശീ	मार्गशी
മാര്ഗീ	मार्गी
മാര്തംദ	मार्तंद
മാര്ഥീകാ	मार्थीका
മാര്യ	मार्य
മാര്യാ	मार्या
മാര്ഷാ	मार्षा
മാലാര്കോഡീ	मालार्केाडी
മാലിനീ	मालिनी
മാല്ലേശാ	माल्लेशा
മാസൂമ	मासूम
മാസൂമീ	मासूमी
മാഹിയാ	माहिया
മാഹിരാജ	माहिराज
മാഹുലീ	माहुली
മിലീ	मिली
മിഹീകാ	मिहीका
മീനാ	मीना
മേധ	मेध
മേധീനീ	मेधीनी
മൈത്രായ	मैत्राय
മൌലീശാ	मॆलीशा
മ്യ്ഥിലീ	म्य्थिली
യംശ	यंश
യക്ഷ	यक्ष
യജും	यजुं
യജുസ	यजुस
യജ്നേശ	यज्नेश
യഥാര്ഥ	यथार्थ
യദുനംദന	यदुनंदन
യശസ്വിനീ	यशस्विनी
യശാശ്രീ	यशाश्री
യശ്ദീപ	यश्दीप
യശ്മിത	यश्मित
യശ്മിതാ	यश्मिता
യശ്വാര്ധാനാ	यश्वार्धाना
യശ്വീന	यश्वीन
യശ്വീനീ	यश्वीनी
യസ്വംഥ	यस्वंथ
യാക്സീനീ	याक्सीनी
യാഗ്നാകായാ	याग्नाकाया
യാഗ്നീഥാ	याग्नीथा
യാചന	याचन
യാതീരാജു	यातीराजु
യാദവീ	यादवी
യാദവേന്ദ്ര	यादवेन्द्र
യാന്തി	यान्ति
യാശ്രീഥാ	याश्रीथा
യാഷ്ക	याष्क
യാസസ്വീ	यासस्वी
യുഗന്തീകാ	युगन्तीका
യുഗപ	युगप
യുഗാന്ധര	युगान्धर
യുതി	युति
യുവംശ	युवंश
യുവനാഥ	युवनाथ
യുവല	युवल
യുവാഥീ	युवाथी
യുവാന  സൂര്യ	युवान  सूर्य
യുവ്നീക	युव्नीक
യേര്രപ്പാ	येर्रप्पा
യേശനാ	येशना
യേശാസ്വീനീ	येशास्वीनी
യേസസരീ	येससरी
യോഗദേവാ	येागदेवा
യോഗരാജ	येागराज
യോഗാനംദ	येागानंद
യോഗിത	येागित
യോഗിതാ	येागिता
യോഗിഥ	येागिथ
യോഗേശ്വര	येागेश्वर
യോഗ്ദീപ	येाग्दीप
യോത്ശനാ	येात्शना
യോനേന്ദ്ര	येानेन्द्र
യോഹ്ശീനീ	येाह्शीनी
യൌവാനീ	यॆवानी
രംഗനാഥ	रंगनाथ
രംജന	रंजन
രംജികാ	रंजिका
രംജീവ	रंजीव
രഈര്ഥ	रईर्थ
രക്ത	रक्त
രക്തകമള	रक्तकमळ
രക്ഷികാ	रक्षिका
രക്ഷിത	रक्षित
രഘവാ	रघवा
രഘവേന്ദര	रघवेन्दर
രഘുനാഥ	रघुनाथ
രജത	रजत
രജനീശ	रजनीश
രജനേശ	रजनेश
രജീത	रजीत
രതന	रतन
രതാംജലി	रतांजलि
രതീക	रतीक
രതുല	रतुल
രത്നാകര	रत्नाकर
രത്നാബലീ	रत्नाबली
രഥനാ	रथना
രന്യ	रन्य
രന്വിഥാ	रन्विथा
രബേക	रबेक
രമാംസ്വമ്യ	रमांस्वम्य
രമ്ബേശ	रम्बेश
രയാന	रयान
രര്ശ്മീതാ	रर्श्मीता
രവി കാന്ത	रवि कान्त
രവികാംത	रविकांत
രവിത	रवित
രവീജാ	रवीजा
രവീനാ	रवीना
രവ്യംകീ	रव्यंकी
രശീലാ	रशीला
രസവംത	रसवंत
രസ്മീന	रस्मीन
രാഈ കുമാര	राई कुमार
രാഖീ	राखी
രാഗാവ	रागाव
രാഗിനീ	रागिनी
രാഗേശ	रागेश
രാഗ്വേദ	राग्वेद
രാജക	राजक
രാജകന്യാ	राजकन्या
രാജഗോപാല	राजगेापाल
രാജയവര്ദന	राजयवर्दन
രാജാ	राजा
രാജാര്ശീ	राजार्शी
രാജികാ	राजिका
രാജീവ	राजीव
രാജേംദ്രമോഹന	राजेंद्रमेाहन
രാജേശ്വര	राजेश्वर
രാജ്യശ്രീ	राज्यश्री
രാധാനീ	राधानी
രാനീ	रानी
രാമ  കീന്കാര	राम  कीन्कार
രാമഗോപാല	रामगेापाल
രാമചന്ദ്രന	रामचन्द्रन
രാമനാരായണ	रामनारायण
രാമരാ	रामरा
രാമരാജ	रामराज
രാമാംസുഗ്രീവാ	रामांसुग्रीवा
രാമാനംദ	रामानंद
രാമാനുജമ	रामानुजम
രാമോജീ	रामेाजी
രാഹിത്യ	राहित्य
രാഹീന്യ	राहीन्य
രാഹുലരാജ	राहुलराज
രിദ്ധി	रिद्धि
രീചികാ	रीचिका
രീതൂ	रीतू
രീഥേകാ	रीथेका
രീദേവ	रीदेव
രീധമാം	रीधमां
രീഭ്യാ	रीभ्या
രീശും	रीशुं
രീശ്മേഥാ	रीश्मेथा
രേഖാ	रेखा
രേത്വിക	रेत्विक
രേധാ	रेधा
രേനാ	रेना
രേനേശ	रेनेश
രേമാംനീകാ	रेमांनीका
രേമീ	रेमी
രേവാതീ	रेवाती
രേവീഥാ	रेवीथा
രേശമീ	रेशमी
രേശ്വീന	रेश्वीन
രേഹാംശീ	रेहांशी
രേഹാനാ	रेहाना
രേഹേഈലാ	रेहेईला
രേഹ്നുഘാ	रेह्नुघा
രൈവത	रैवत
രൈവതാ	रैवता
ലംഗീത	लंगीत
ലക്ഷ	लक्ष
ലക്ഷാകീ	लक्षाकी
ലക്ഷിതാ	लक्षिता
ലക്ഷ്മീകാനതമ	लक्ष्मीकानतम
ലജ്ജാ	लज्जा
ലജ്ജാകാ	लज्जाका
ലതാ	लता
ലതേശ	लतेश
ലവപാല	लवपाल
ലവലീന	लवलीन
ലഹരീ	लहरी
ലാക്ശേതാ	लाक्शेता
ലാജവംതീ	लाजवंती
ലാതീശ	लातीश
ലാനീബന	लानीबन
ലാഭാ	लाभा
ലാമ്ബോധാര	लाम्बेाधार
ലാരീനാ	लारीना
ലാര്മികാ	लार्मिका
ലാര്രാജ	लार्राज
ലാര്ശന	लार्शन
ലാവനീ	लावनी
ലാവിനാ	लाविना
ലീകേശ	लीकेश
ലീത്സാ	लीत्सा
ലീനാശാ	लीनाशा
ലീനീത	लीनीत
ലീപാക്ഷീ	लीपाक्षी
ലീപ്സീകാ	लीप्सीका
ലീമനാ	लीमना
ലീലാമഈ	लीलामई
ലീശാംത	लीशांत
ലുസിയാ	लुसिया
ലേഈവീനാ	लेईवीना
ലേഖീശാ	लेखीशा
ലേമാര	लेमार
ലോകനേത്ര	लेाकनेत्र
ലോകാജനാനീ	लेाकाजनानी
ലോകാമാത്രീ	लेाकामात्री
ലോകീഥാ	लेाकीथा
ലോകേന്ദ്ര	लेाकेन्द्र
ലോഗീനീ	लेागीनी
ലോഗേശ്വരണ	लेागेश्वरण
ലോചനാ	लेाचना
ലോനാ	लेाना
ലോമാംകേശ	लेामांकेश
ലോഹിത	लेाहित
ലോഹിതാശ്വാ	लेाहिताश्वा
ലൌക്യ	लॆक्य
വംദിതാ	वंदिता
വംസികൃഷ്ണ	वंसिकृष्ण
വനദ	वनद
വനമാംഥീ	वनमांथी
വനസ	वनस
വനിനാധ	वनिनाध
വന്ജുല	वन्जुल
വപുസ	वपुस
വയദീശ	वयदीश
വരലീ	वरली
വരിന	वरिन
വരിയാസ	वरियास
വരുന	वरुन
വരുനികാ	वरुनिका
വര്ണിത	वर्णित
വര്ധമാന	वर्धमान
വര്ധാനീ	वर्धानी
വര്ധീമൈനകാപുജീതാ	वर्धीमैनकापुजीता
വര്നീശാ	वर्नीशा
വര്ശനേയാ	वर्शनेया
വര്ശീകാ	वर्शीका
വര്ശീതാ	वर्शीता
വര്ശീദ	वर्शीद
വര്ഷനീ	वर्षनी
വല്ലികാ	वल्लिका
വസംതാ	वसंता
വസംതീ	वसंती
വസീസതാ	वसीसता
വസുമിത്ര	वसुमित्र
വസുസേന	वसुसेन
വാക്പതി	वाक्पति
വാക്ഷു	वाक्षु
വാച്യ	वाच्य
വാജ്രക്ഷ	वाज्रक्ष
വാതത്മാജ	वातत्माज
വാത്സല്യ	वात्सल्य
വാദിവേലും	वादिवेलुं
വാനര	वानर
വാന്ശുല	वान्शुल
വാമന	वामन
വാമാംക്ഷീ	वामांक्षी
വാമീല	वामील
വാരനാ	वारना
വാരുനീ	वारुनी
വാലാരമാംഥീ	वालारमांथी
വാല്ല്മാംനാലന	वाल्ल्मांनालन
വാശു	वाशु
വാസുമന	वासुमन
വാഹിനീ	वाहिनी
വികീശാ	विकीशा
വിക്ഷിത	विक्षित
വിജയാലക്ഷ്മീ	विजयालक्ष्मी
വിജയാശാനഥീ	विजयाशानथी
വിജീതാ	विजीता
വിദിശാ	विदिशा
വിദ്യാ	विद्या
വിദ്യുല	विद्युल
വിധാഥരീ	विधाथरी
വിന്ധുജാ	विन्धुजा
വിബാലീ	विबाली
വിഭാവാ	विभावा
വിഭൂതി	विभूति
വിഭൂഷ	विभूष
വിയാമര്ശ	वियामर्श
വിരഗനാപതീ	विरगनापती
വിരഭാദ്രപ്പാ	विरभाद्रप्पा
വിരാജ	विराज
വിലാശീനീ	विलाशीनी
വീണാ	वीणा
വീണാധാരീ	वीणाधारी
വേക്രാംത	वेक्रांत
വേഗ	वेग
വേഗവാഹീനീ	वेगवाहीनी
വേഗീ	वेगी
വേണു	वेणु
വേത്ത്രീ	वेत्त्री
വേത്രിവാല	वेत्रिवाल
വേത്രീവേല	वेत्रीवेल
വേദകാര്തിക	वेदकार्तिक
വേദവല്ലീ	वेदवल्ली
വേദാ	वेदा
വേദാ ശ്രീ	वेदा श्री
വേധാംത	वेधांत
വേന്കാത്രമണ	वेन्कात्रमण
വേന്തന	वेन्तन
വേന്നേലാ	वेन्नेला
വേന്മതീ	वेन्मती
വേലു	वेलु
വേഹംത	वेहंत
വൈകുംഠ	वैकुंठ
വൈജീനാഥ	वैजीनाथ
വൈദത	वैदत
വൈദേഹീ	वैदेही
വൈദ്യുംത	वैद्युंत
വൈധേ	वैधे
വൈധ്യാത	वैध्यात
വൈരാഗ	वैराग
വൈരോചന	वैरेाचन
വൈശാലീ	वैशाली
വൈശ്വീ	वैश्वी
വൈഷ്ണവീ	वैष्णवी
വൈസകാ	वैसका
സംക്രാംതി	संक्रांति
സംഗമിത്ര	संगमित्र
സംഗമീധീരാ	संगमीधीरा
സംചയ	संचय
സംചീതീ	संचीती
സംജേനാ	संजेना
സംജോലീ	संजेाली
സംതോക	संतेाक
സംദിപോന	संदिपेान
സംദീപ	संदीप
സംദേശ	संदेश
സംധരാ	संधरा
സംധ്യാ	संध्या
സംബീതാ	संबीता
സംമീതാ	संमीता
സംയുക്ത	संयुक्त
സംവിധാ	संविधा
സംവീഥാ	संवीथा
സംസ്കൃതി	संस्कृति
സംഹിത	संहित
സക്ശീന്യാ	सक्शीन्या
സഖ്യാ	सख्या
സഗന	सगन
സഗുനാ	सगुना
സചിതാ	सचिता
സചിദാനംദ വിഗ്രഹ	सचिदानंद विग्रह
സചേതന	सचेतन
സച്ചിദാനംദാ	सच्चिदानंदा
സജീത	सजीत
സജീലീ	सजीली
സദഗതി	सदगति
സദഗുനാ	सदगुना
സദാശിവ	सदाशिव
സദിശ	सदिश
സപനാ	सपना
സപുഷ്പാ	सपुष्पा
സപ്താബീ	सप्ताबी
സപ്തോര്ശീ	सप्तेार्शी
സമജാ	समजा
സമദര്ശീ	समदर्शी
സമഭ്ദ്ധാ	समभ्द्धा
സമരേശ	समरेश
സമാംദ്രിതാ	समांद्रिता
സമാംര്ധ	समांर्ध
സമാജസ	समाजस
സമാരാസ്യാ	समारास्या
സമിക	समिक
സമിരന	समिरन
സമേംദ്ര	समेंद्र
സമേശ	समेश
സമ്പൂര്ണ	सम्पूर्ण
സമ്പ്രഥ്യ	सम्प्रथ्य
സമ്പ്രീതീ	सम्प्रीती
സമ്രാട	सम्राट
സമ്രീധ	सम्रीध
സരസംഗീ	सरसंगी
സലീജ	सलीज
സഹര്സീതാ	सहर्सीता
സഹശ്രദ	सहश्रद
സഹസ്ത്രജീത	सहस्त्रजीत
സഹസ്ത്രബാഹു	सहस्त्रबाहु
സഹീത	सहीत
സഹീരാമ	सहीराम
സഹ്യ	सह्य
സാംജ	सांज
സാഇ രാമ	साइ राम
സാഈനാഥ	साईनाथ
സാചീ	साची
സാജന	साजन
സാദ്രീശീ	साद्रीशी
സാദ്വിഥാ	साद्विथा
സാധന	साधन
സാധ്യാ	साध्या
സാനിധ്യ	सानिध्य
സാമംതാ	सामंता
സാമ്ഭാ	साम्भा
സാരണീ	सारणी
സാരഥീ	सारथी
സാരികാ	सारिका
സാലവീ	सालवी
സാലസാ	सालसा
സൈകത	सैकत
സൈനീത്യ	सैनीत्य
സൈന്ധന്യ	सैन्धन्य
സൈലീ	सैली
സൈഹാര്സന	सैहार्सन
ഹംസമാലാ	हंसमाला
ഹംസാവാഥ്യ	हंसावाथ्य
ഹനാര്വീന	हनार्वीन
ഹനീതാ	हनीता
ഹനുപ	हनुप
ഹനുമാന	हनुमान
ഹബീതാ	हबीता
ഹമസാദീപികാ	हमसादीपिका
ഹമസാനംദീനീ	हमसानंदीनी
ഹമീര	हमीर
ഹരജീത	हरजीत
ഹരജീവന	हरजीवन
ഹരനാധ	हरनाध
ഹരശും	हरशुं
ഹരികിശന	हरिकिशन
ഹരിഗംഗാ	हरिगंगा
ഹരിഗോപാല	हरिगेापाल
ഹരിദാസ	हरिदास
ഹരിദ്വാര	हरिद्वार
ഹരിപ്രീത	हरिप्रीत
ഹരിമംതീ	हरिमंती
ഹരീ	हरी
ഹരേശ്വര	हरेश्वर
ഹര്മീന	हर्मीन
ഹര്ഷണ	हर्षण
ഹര്സികാ	हर्सिका
ഹശ്മീതാ	हश्मीता
ഹസമുഖ	हसमुख
ഹസീതാ	हसीता
ഹസ്വീഥാ	हस्वीथा
ഹാര്ദീനീ	हार्दीनी
ഹാര്ശീനീ	हार्शीनी
ഹാലിക	हालिक
ഹിംഡോള	हिंडेाळ
ഹിംദോലാ	हिंदेाला
ഹിതാക്ഷീ	हिताक्षी
ഹിതീ	हिती
ഹിഥീക്സാ	हिथीक्सा
ഹിമാംശു	हिमांशु
ഹിമാക്ഷ	हिमाक्ष
ഹിമാലയ	हिमालय
ഹിരംയക	हिरंयक
ഹിരവ	हिरव
ഹിരവാ	हिरवा
ഹിരുധായാ	हिरुधाया
ഹിവാ	हिवा
ഹീരാനമാം	हीरानमां
ഹീരാന്യാപ്രകാഈ	हीरान्याप्रकाई
ഹീര്നാക്ഷീ	हीर्नाक्षी
ഹുവീശ്കാ	हुवीश्का
ഹൃദയനാഥ	हृदयनाथ
ഹേഈദീ	हेईदी
ഹേജല	हेजल
ഹേതാ	हेता
ഹേതാശ	हेताश
ഹേത്ശ്രീ	हेत्श्री
ഹേഥാന്ശ്രീ	हेथान्श्री
ഹേനീത	हेनीत
ഹേനീല	हेनील
ഹേമനാഥ	हेमनाथ
ഹേമലതാ	हेमलता
ഹേമാ	हेमा
ഹേമാംദ്രികാ	हेमांद्रिका
ഹേമാഗൌരീ	हेमागॆरी
ഹേമാനംദ	हेमानंद
ഹേമാലാ	हेमाला
ഹേമാവതീ	हेमावती
ഹേമാവാതിനംദന	हेमावातिनंदन
ഹേമേംദു	हेमेंदु
ഹേയന	हेयन
ഹേയാംശ	हेयांश
ഹേരീത	हेरीत
ഹേലീ	हेली
ഹോന്നേശാ	हेान्नेशा
ഹോമാ	हेामा
ഹ്രീത്വിക	ह्रीत्विक
ഹ്രീദാന്ക്ഷ	ह्रीदान्क्ष
ഹ്രീധാന	ह्रीधान
ഹ്രീശന	ह्रीशन
ഹ്രീശാംത	ह्रीशांत
ഹ്രീഷിത	ह्रीषित
ഹ്രുദയ	ह्रुदय
ഹ്രുശാല	ह्रुशाल
ഹ്രേയാംശ	ह्रेयांश
ഹ്ര്യ്ദയേശ	ह्र्य्दयेश
#
#
# Territory names from CLDR
അസൻഷൻ ദ്വീപ്	असൻषൻ द्वीप्
അന്റോറ	अन्ऱेाऱ
യുണൈറ്റഡ് അറബ് എമിറൈറ്റ്‌സ്	युणैऱ्ऱड् अऱब् ऎमिऱैऱ्ऱ्‌स्
അഫ്‌ഗാനിസ്ഥാൻ	अफ्‌गानिस्थाൻ
ആൻറിഗ്വയും ബർബുഡയും	आൻऱिग्वयुं बർबुडयुं
ആൻഗ്വില്ല	आൻग्विल्ल
അൽബേനിയ	अൽबेनिय
അർമേനിയ	अർमेनिय
അംഗോള	अंगेाळ
അൻറാർട്ടിക്ക	अൻऱाർट्टिक्क
അർജൻറീന	अർजൻऱीन
അമേരിക്കൻ സമോവ	अमेरिक्कൻ समेाव
ഓസ്ട്രിയ	ओस्ट्रिय
ഓസ്‌ട്രേലിയ	ओस्‌ट्रेलिय
അറൂബ	अऱूब
അലൻഡ് ദ്വീപുകൾ	अलൻड् द्वीपुकൾ
അസർബൈജാൻ	असർबैजाൻ
ബോസ്നിയയും ഹെർസഗോവിനയും	बेास्निययुं हॆർसगेाविनयुं
ബാർബഡോസ്	बाർबडेास्
ബംഗ്ലാദേശ്	बंग्लादेश्
ബെൽജിയം	बॆൽजियं
ബുർക്കിനാ ഫാസോ	बुർक्किना फासेा
ബൾഗേറിയ	बൾगेऱिय
ബഹ്റിൻ	बह्ऱिൻ
ബറുണ്ടി	बऱुण्टि
ബെനിൻ	बॆनिൻ
സെന്റ് ബാർത്തലമി	सॆन्ऱ् बाർत्तलमि
ബർമുഡ	बർमुड
ബ്രൂണൈ	ब्रूणै
ബൊളീവിയ	बॆाळीविय
ബൊണെയ്ർ, സിന്റ് യുസ്റ്റേഷ്യസ്, സാബ എന്നിവ	बॆाणॆय्ർ, सिन्ऱ् युस्ऱ्ऱेष्यस्, साब ऎन्निव
ബ്രസീൽ	ब्रसीൽ
ബഹാമാസ്	बहामास्
ഭൂട്ടാൻ	भूट्टाൻ
ബൗവെട്ട് ദ്വീപ്	बवॆट्ट् द्वीप्
ബോട്സ്വാന	बेाट्स्वान
ബെലറൂസ്	बॆलऱूस्
ബെലീസ്	बॆलीस्
കാനഡ	कानड
കോക്കസ് (കീലിംഗ്) ദ്വീപുകൾ	केाक्कस् (कीलिंग्) द्वीपुकൾ
കോംഗോ - കിൻഷാസ	केांगेा - किൻषास
കോംഗോ (DRC)	केांगेा (DRC)
സെൻട്രൽ ആഫ്രിക്കൻ റിപ്പബ്ലിക്	सॆൻट्रൽ आफ्रिक्कൻ ऱिप्पब्लिक्
കോംഗോ - ബ്രാസവില്ലി	केांगेा - ब्रासविल्लि
കോംഗോ (റിപ്പബ്ലിക്ക്)	केांगेा (ऱिप्पब्लिक्क्)
സ്വിറ്റ്സർലാൻഡ്	स्विऱ्ऱ्सർलाൻड्
കോട്ട് ഡി വാർ	केाट्ट् डि वाർ
ഐവറി കോസ്റ്റ്	ऐवऱि केास्ऱ्ऱ्
കുക്ക് ദ്വീപുകൾ	कुक्क् द्वीपुकൾ
ചിലി	चिलि
കാമറൂൺ	कामऱूൺ
ചൈന	चैन
കൊളംബിയ	कॆाळंबिय
ക്ലിപ്പെർട്ടൻ ദ്വീപ്	क्लिप्पॆർट्टൻ द्वीप्
കോസ്റ്ററിക്ക	केास्ऱ्ऱऱिक्क
ക്യൂബ	क्यूब
കേപ്പ് വെർദെ	केप्प् वॆർदॆ
കുറാകാവോ	कुऱाकावेा
ക്രിസ്മസ് ദ്വീപ്	क्रिस्मस् द्वीप्
സൈപ്രസ്	सैप्रस्
ചെക്ക് റിപ്പബ്ലിക്	चॆक्क् ऱिप्पब्लिक्
ജർമനി	जർमनि
ഡീഗോ ഗ്രാഷ്യ	डीगेा ग्राष्य
ദിജിബൗട്ടി	दिजिबट्टि
ഡെൻമാർക്ക്	डॆൻमाർक्क्
ഡൊമിനിക്ക	डॆामिनिक्क
ഡൊമിനിക്കൻ റിപ്പബ്ലിക്	डॆामिनिक्कൻ ऱिप्पब्लिक्
അൾജീരിയ	अൾजीरिय
സെയൂത്ത ആൻഡ് മെലിയ	सॆयूत्त आൻड् मॆलिय
ഇക്വഡോർ	इक्वडेाർ
എസ്റ്റോണിയ‍	ऎस्ऱ्ऱेाणिय‍
ഈജിപ്ത്	ईजिप्त्
പശ്ചിമ സഹാറ	पश्चिम सहाऱ
എറിത്രിയ	ऎऱित्रिय
സ്‌പെയിൻ	स्‌पॆयिൻ
എത്യോപ്യ	ऎत्येाप्य
യൂറോപ്യൻ യൂണിയൻ	यूऱेाप्यൻ यूणियൻ
ഫിൻലാൻഡ്	फिൻलाൻड्
ഫിജി	फिजि
ഫാക്ക്‌ലാന്റ് ദ്വീപുകൾ	फाक्क्‌लान्ऱ् द्वीपुकൾ
ഫോക്ക്‌ലാൻഡ് ദ്വീപുകൾ (ഐലാസ് മാൽവിനാസ്)	फेाक्क्‌लाൻड् द्वीपुकൾ (ऐलास् माൽविनास्)
മൈക്രോനേഷ്യ	मैक्रेानेष्य
ഫറോ ദ്വീപുകൾ	फऱेा द्वीपुकൾ
ഫ്രാൻസ്	फ्राൻस्
ഗാബൺ	गाबൺ
യുണൈറ്റഡ് കിംഗ്ഡം	युणैऱ्ऱड् किंग्डं
ഗ്രനേഡ	ग्रनेड
ജോർജ്ജിയ	जेाർज्जिय
ഫ്രഞ്ച് ഗയാന	फ्रञ्च् गयान
ഗേൺസി	गेൺसि
ഘാന	घान
ജിബ്രാൾട്ടർ	जिब्राൾट्टർ
ഗ്രീൻലാൻറ്	ग्रीൻलाൻऱ्
ഗാംബിയ	गांबिय
ഗിനിയ	गिनिय
ഗ്വാഡലൂപ്പ്	ग्वाडलूप्प्
ഇക്വറ്റോറിയൽ ഗിനിയ	इक्वऱ्ऱेाऱियൽ गिनिय
ഗ്രീസ്	ग्रीस्
ദക്ഷിണ ജോർജ്ജിയയും ദക്ഷിണ സാൻഡ്‌വിച്ച് ദ്വീപുകളും	दक्षिण जेाർज्जिययुं दक्षिण साൻड्‌विच्च् द्वीपुकळुं
ഗ്വാട്ടിമാല	ग्वाट्टिमाल
ഗ്വാം	ग्वां
ഗിനിയ-ബിസൗ	गिनिय-बिस
ഗയാന	गयान
ഹോങ്കോങ്ങ് (SAR) ചൈന	हेाङ्केाङ्ङ् (SAR) चैन
ഹോങ്കോങ്ങ്	हेाङ्केाङ्ङ्
ഹിയേർഡും മക്‌ഡൊണാൾഡ് ദ്വീപുകളും	हियेർडुं मक्‌डॆाणाൾड् द्वीपुकळुं
ഹോണ്ടുറാസ്	हेाण्टुऱास्
ക്രൊയേഷ്യ	क्रॆायेष्य
ഹെയ്തി	हॆय्ति
ഹംഗറി	हंगऱि
കാനറി ദ്വീപുകൾ	कानऱि द्वीपुकൾ
ഇന്തോനേഷ്യ	इन्तेानेष्य
അയർലാൻഡ്	अयർलाൻड्
ഇസ്രായേൽ	इस्रायेൽ
ഐൽ ഓഫ് മാൻ	ऐൽ ओफ् माൻ
ഇന്ത്യ	इन्त्य
ബ്രിട്ടീഷ് ഇന്ത്യൻ മഹാസമുദ്ര പ്രദേശം	ब्रिट्टीष् इन्त्यൻ महासमुद्र प्रदेशं
ഇറാഖ്	इऱाख्
ഇറാൻ	इऱाൻ
ഐസ്‌ലാന്റ്	ऐस्‌लान्ऱ्
ഇറ്റലി	इऱ्ऱलि
ജേഴ്സി	जेऴ्सि
ജമൈക്ക	जमैक्क
ജോർദ്ദാൻ	जेाർद्दाൻ
ജപ്പാൻ	जप्पाൻ
കെനിയ	कॆनिय
കിർഗിസ്ഥാൻ	किർगिस्थाൻ
കംബോഡിയ	कंबेाडिय
കിരിബാട്ടി	किरिबाट्टि
കോമൊറോസ്	केामॆाऱेास्
സെന്റ് കിറ്റ്‌സും നെവിസും	सॆन्ऱ् किऱ्ऱ्‌सुं नॆविसुं
ഉത്തരകൊറിയ	उत्तरकॆाऱिय
ദക്ഷിണകൊറിയ	दक्षिणकॆाऱिय
കുവൈറ്റ്	कुवैऱ्ऱ्
കേമാൻ ദ്വീപുകൾ	केमाൻ द्वीपुकൾ
കസാഖിസ്ഥാൻ	कसाखिस्थाൻ
ലാവോസ്	लावेास्
ലെബനൻ	लॆबनൻ
സെൻറ് ലൂസിയ	सॆൻऱ् लूसिय
ലിച്ചൺസ്റ്റൈൻ	लिच्चൺस्ऱ्ऱैൻ
ശ്രീലങ്ക	श्रीलङ्क
ലൈബീരിയ	लैबीरिय
ലെസോതോ	लॆसेातेा
ലിത്വാനിയ	लित्वानिय
ലക്സംബർഗ്	लक्संबർग्
ലാറ്റ്വിയ	लाऱ्ऱ्विय
ലിബിയ	लिबिय
മൊറോക്കൊ	मॆाऱेाक्कॆा
മൊണാക്കോ	मॆाणाक्केा
മൾഡോവ	मൾडेाव
മോണ്ടെനെഗ്രോ	मेाण्टॆनॆग्रेा
സെൻറ് മാർട്ടിൻ	सॆൻऱ् माർट्टिൻ
മഡഗാസ്കർ	मडगास्कർ
മാർഷൽ‍‍ ദ്വീപുകൾ	माർषൽ‍‍ द्वीपुकൾ
മാസിഡോണിയ	मासिडेाणिय
മാസിഡോണിയ (FYROM)	मासिडेाणिय (FYROM)
മാലി	मालि
മ്യാൻമാർ (ബർമ്മ)	म्याൻमाർ (बർम्म)
മംഗോളിയ	मंगेाळिय
മക്കാവു (SAR) ചൈന	मक्कावु (SAR) चैन
മക്കാവു	मक्कावु
ഉത്തര മറിയാനാ ദ്വീപുകൾ	उत्तर मऱियाना द्वीपुकൾ
മാർട്ടിനിക്ക്	माർट्टिनिक्क्
മൗറിറ്റാനിയ	मऱिऱ्ऱानिय
മൊണ്ടെസരത്ത്	मॆाण्टॆसरत्त्
മാൾട്ട	माൾट्ट
മൗറീഷ്യസ്	मऱीष्यस्
മാലിദ്വീപ്	मालिद्वीप्
മലാവി	मलावि
മെക്സിക്കോ	मॆक्सिक्केा
മലേഷ്യ	मलेष्य
മൊസാംബിക്ക്	मॆासांबिक्क्
നമീബിയ	नमीबिय
പുതിയ കാലിഡോണിയ	पुतिय कालिडेाणिय
നൈജർ	नैजർ
നോർഫോക് ദ്വീപ്	नेाർफेाक् द्वीप्
നൈജീരിയ	नैजीरिय
നിക്കരാഗ്വ	निक्कराग्व
നെതർലാൻഡ്‌സ്	नॆतർलाൻड्‌स्
നോർവെ	नेाർवॆ
നേപ്പാൾ	नेप्पाൾ
നൗറു	नऱु
ന്യൂയി	न्यूयि
ന്യൂസിലാൻറ്	न्यूसिलाൻऱ्
ഒമാൻ	ऒमाൻ
പനാമ	पनाम
പെറു	पॆऱु
ഫ്രഞ്ച് പോളിനേഷ്യ	फ्रञ्च् पेाळिनेष्य
പാപ്പുവ ന്യൂ ഗിനിയ	पाप्पुव न्यू गिनिय
ഫിലിപ്പൈൻസ്	फिलिप्पैൻस्
പാക്കിസ്ഥാൻ	पाक्किस्थाൻ
പോളണ്ട്	पेाळण्ट्
സെന്റ് പിയറിയും മിക്കലണും	सॆन्ऱ् पियऱियुं मिक्कलणुं
പിറ്റ്‌കെയ്‌ൻ ദ്വീപുകൾ	पिऱ्ऱ्‌कॆय्‌ൻ द्वीपुकൾ
പ്യൂർട്ടോ റിക്കോ	प्यूർट्टेा ऱिक्केा
പാലസ്‌തീൻ പ്രദേശങ്ങൾ	पालस्‌तीൻ प्रदेशङ्ङൾ
പലസ്‌തീൻ	पलस्‌तीൻ
പോർച്ചുഗൽ	पेाർच्चुगൽ
പലാവു	पलावु
പരാഗ്വേ	पराग्वे
ഖത്തർ	खत्तർ
ദ്വീപസമൂഹം	द्वीपसमूहं
റീയൂണിയൻ	ऱीयूणियൻ
റൊമാനിയ	ऱॆामानिय
സെർബിയ	सॆർबिय
റഷ്യ	ऱष्य
റുവാണ്ട	ऱुवाण्ट
സൗദി അറേബ്യ	सदि अऱेब्य
സോളമൻ‍ ദ്വീപുകൾ	सेाळमൻ‍ द्वीपुकൾ
സെയ്‌ഷെൽസ്	सॆय्‌षॆൽस्
സുഡാൻ	सुडाൻ
സ്വീഡൻ	स्वीडൻ
സിംഗപ്പുർ	सिंगप्पुർ
സെൻറ് ഹെലീന	सॆൻऱ् हॆलीन
സ്ലോവേനിയ	स्लेावेनिय
സ്വാൽബാഡും ജാൻ മായേനും	स्वाൽबाडुं जाൻ मायेनुं
സ്ലോവാക്യ	स्लेावाक्य
സിയെറ ലിയോൺ	सियॆऱ लियेाൺ
സാൻ മറിനോ	साൻ मऱिनेा
സെനഗൽ	सॆनगൽ
സോമാലിയ	सेामालिय
സുരിനെയിം	सुरिनॆयिं
ദക്ഷിണ സുഡാൻ	दक्षिण सुडाൻ
സാവോ ടോമും പ്രിൻസിപെയും	सावेा टेामुं प्रिൻसिपॆयुं
എൽ സാൽവദോർ	ऎൽ साൽवदेाർ
സിന്റ് മാർട്ടെൻ	सिन्ऱ् माർट्टॆൻ
സിറിയ	सिऱिय
സ്വാസിലാൻറ്	स्वासिलाൻऱ्
ട്രസ്റ്റൻ ഡ കൂന	ट्रस्ऱ्ऱൻ ड कून
ടർക്ക്‌സും കെയ്‌ക്കോ ദ്വീപുകളും	टർक्क्‌सुं कॆय्‌क्केा द्वीपुकळुं
ഛാഡ്	छाड्
ഫ്രഞ്ച് ദക്ഷിണ ഭൂപ്രദേശം	फ्रञ्च् दक्षिण भूप्रदेशं
ടോഗോ	टेागेा
തായ്‌ലാൻഡ്	ताय्‌लाൻड्
താജിക്കിസ്ഥാൻ	ताजिक्किस्थाൻ
ടോക്കെലൂ	टेाक्कॆलू
തിമോർ-ലെസ്റ്റെ	तिमेाർ-लॆस्ऱ्ऱॆ
കിഴക്കൻ തിമോർ	किऴक्कൻ तिमेाർ
തുർക്ക്മെനിസ്ഥാൻ	तुർक्क्मॆनिस्थाൻ
ടുണീഷ്യ	टुणीष्य
ടോംഗ	टेांग
തുർക്കി	तुർक्कि
ട്രിനിഡാഡും ടുബാഗോയും	ट्रिनिडाडुं टुबागेायुं
ടുവാലു	टुवालु
തായ്‌വാൻ	ताय्‌वाൻ
ടാൻസാനിയ	टाൻसानिय
ഉക്രെയ്‌ൻ	उक्रॆय्‌ൻ
ഉഗാണ്ട	उगाण्ट
അമേരിക്കൻ ഐക്യനാടുകൾ	अमेरिक्कൻ ऐक्यनाटुकൾ
ഉറുഗ്വേ	उऱुग्वे
ഉസ്‌ബെക്കിസ്ഥാൻ	उस्‌बॆक्किस्थाൻ
വത്തിക്കാൻ	वत्तिक्काൻ
സെന്റ് വിൻസെന്റും ഗ്രനെഡൈൻസും	सॆन्ऱ् विൻसॆन्ऱुं ग्रनॆडैൻसुं
വെനിസ്വേല	वॆनिस्वेल
ബ്രിട്ടീഷ് വെർജിൻ ദ്വീപുകൾ	ब्रिट्टीष् वॆർजिൻ द्वीपुकൾ
വിയറ്റ്നാം	वियऱ्ऱ्नां
വന്വാതു	वन्वातु
വാലിസ് ആന്റ് ഫ്യൂച്യുന	वालिस् आन्ऱ् फ्यूच्युन
സമോവ	समेाव
കൊസോവൊ	कॆासेावॆा
യെമൻ	यॆमൻ
മയോട്ടി	मयेाट्टि
ദക്ഷിണാഫ്രിക്ക	दक्षिणाफ्रिक्क
സാംബിയ	सांबिय
സിംബാബ്‌വേ	सिंबाब्‌वे
അജ്ഞാത പ്രദേശം	अज्ञात प्रदेशं
