# Baby names
അകര്ശാനാ	ଅକର୍ଶାନା
അക്ശൈനീഏ	ଅକ୍ଶୈନୀଏ
അഗജാ	ଅଗଜା
അചിംത	ଅଚିଂତ
അചിത	ଅଚିତ
അച്ചിന്ദ്ര	ଅଚ୍ଚିନ୍ଦ୍ର
അഡ്യാദവൈതാ	ଅଡ୍ଯାଦଵୈତା
അദഭുതഃ	ଅଦଭୁତଃ
അദേന്യ	ଅଦେନ୍ଯ
അദേല	ଅଦେଲ
അദ്രിതീ	ଅଦ୍ରିତୀ
അദ്രീഥീ	ଅଦ୍ରୀଥୀ
അദ്രീമാം	ଅଦ୍ରୀମାଂ
അദ്വൈയാ	ଅଦ୍ଵୈଯା
അധര്ഷ	ଅଧର୍ଷ
അധിപാ	ଅଧିପା
അധീരതാ	ଅଧୀରତା
അധ്യുത	ଅଧ୍ଯୁତ
അനംതാമായാ	ଅନଂତାମାଯା
അബരനാ	ଅବରନା
അബിനയ	ଅବିନଯ
അബിനാ	ଅବିନା
അബീനംദാ	ଅବୀନଂଦା
അബീശാ	ଅବୀଶା
അഭയ	ଅଭଯ
അഭയന	ଅଭଯନ
അഭിഗ്ന്യാ	ଅଭିଗ୍ନ୍ଯା
അഭിജീതാ	ଅଭିଜୀତା
അഭിനിവേശ	ଅଭିନିଵେଶ
അഭിമ	ଅଭିମ
അഭിമാനീ	ଅଭିମାନୀ
അഭിമോദാ	ଅଭିମୋଦା
അഭിരാ	ଅଭିରା
അഭിരാത	ଅଭିରାତ
അഭീരല	ଅଭୀରଲ
അഭീശ്രേയ	ଅଭୀଶ୍ରେଯ
അഭീസുമത	ଅଭୀସୁମତ
അഭ്യപ്സീത	ଅଭ୍ଯପ୍ସୀତ
അഭ്യുദയാ	ଅଭ୍ଯୁଦଯା
അമൃതാ	ଅମୃତା
അലകനംദാ	ଅଲକନଂଦା
അലക്ഷാ	ଅଲକ୍ଷା
അല്കാ	ଅଲ୍କା
അശവ	ଅଶଵ
അശ്നേഇല	ଅଶ୍ନେଇଲ
ആകാശലീനാ	ଆକାଶଲୀନା
ആകൃഥീ	ଆକୃଥୀ
ആക്ഷ്യാ	ଆକ୍ଷ୍ଯା
ആചാര്യ	ଆଚାର୍ଯ
ആത്മയ	ଆତ୍ମଯ
ആദി	ଆଦି
ആദിമ	ଆଦିମ
ആദീവ	ଆଦୀଵ
ആധീരേന	ଆଧୀରେନ
ആധ്യാ	ଆଧ୍ଯା
ആനംദീനീ	ଆନଂଦୀନୀ
ആനീകാ	ଆନୀକା
ആന്തീകാ	ଆନ୍ତୀକା
ആന്വീ	ଆନ୍ଵୀ
ആപ്ത	ଆପ୍ତ
ആപ്തി	ଆପ୍ତି
ആമാംനീ	ଆମାଂନୀ
ആമിഷ	ଆମିଷ
ആമുക്ഥാ	ଆମୁକ୍ଥା
ആയുസ	ଆଯୁସ
ആയോദ	ଆଯୋଦ
ആരംഭീ	ଆରଂଭୀ
ആരതീ	ଆରତୀ
ആരസീ	ଆରସୀ
ആര്യ	ଆର୍ଯ
ആര്യക	ଆର୍ଯକ
ആര്യനാ	ଆର୍ଯନା
ആര്യമാനീ	ଆର୍ଯମାନୀ
ആലേഃയാ	ଆଲେଃଯା
ആവംശ	ଆଵଂଶ
ആവേശ	ଆଵେଶ
ആശകാ	ଆଶକା
ആശിയാനാ	ଆଶିଯାନା
ആശുതോഷ	ଆଶୁତୋଷ
ആശ്മീന	ଆଶ୍ମୀନ
ആശ്വിത	ଆଶ୍ଵିତ
ആസവ	ଆସଵ
ആസ്തിക	ଆସ୍ତିକ
ഇക്ശാനാ	ଇକ୍ଶାନା
ഇജയാ	ଇଜଯା
ഇനീയന	ଇନୀଯନ
ഇനോദയ	ଇନୋଦଯ
ഇന്ദരകാന്ത	ଇନ୍ଦରକାନ୍ତ
ഇന്ദിവാരസ	ଇନ୍ଦିଵାରସ
ഇന്ദുശിതാലാ	ଇନ୍ଦୁଶିତାଲା
ഇന്ദ്രജാ	ଇନ୍ଦ୍ରଜା
ഇന്ദ്രതന	ଇନ୍ଦ୍ରତନ
ഇന്ദ്രദയുമ്ന	ଇନ୍ଦ୍ରଦଯୁମ୍ନ
ഇന്ദ്രവദന	ଇନ୍ଦ୍ରଵଦନ
ഇന്ദ്രാണീ	ଇନ୍ଦ୍ରାଣୀ
ഇബ്ബാനീ	ଇବ୍ବାନୀ
ഇയുരേശ	ଇଯୁରେଶ
ഇയേനഗര	ଇଯେନଗର
ഇരാജ	ଇରାଜ
ഇരിത	ଇରିତ
ഇരേശ	ଇରେଶ
ഇലിസാ	ଇଲିସା
ഇശിതാ	ଇଶିତା
ഇശ്വാര്യ	ଇଶ୍ଵାର୍ଯ
ഇഷ്ടാ	ଇଷ୍ଟା
ഇഷ്ടി	ଇଷ୍ଟି
ഇസാര	ଇସାର
ഇസ്ശും	ଇସ୍ଶୁଂ
ഈതന	ଈତନ
ഈതികാ	ଈତିକା
ഈരേന്പ്രിത	ଈରେନ୍ପ୍ରିତ
ഈര്ശീതാ	ଈର୍ଶୀତା
ഈലാക്കീയാ	ଈଲାକ୍କୀଯା
ഈലികാ	ଈଲିକା
ഈലേശാ	ଈଲେଶା
ഈശാര	ଈଶାର
ഈശിക	ଈଶିକ
ഈശ്വരദത്ത	ଈଶ୍ଵରଦତ୍ତ
ഈഹാ	ଈହା
ഉഗ്രസ്രവാസ	ଉଗ୍ରସ୍ରଵାସ
ഉജവണീ	ଉଜଵଣୀ
ഉജേശാ	ଉଜେଶା
ഉജ്ജന	ଉଜ୍ଜନ
ഉജ്ജവല	ଉଜ୍ଜଵଲ
ഉജ്ജവാലാ	ଉଜ୍ଜଵାଲା
ഉജ്ജ്വലാ /ഉജ്വലാ	ଉଜ୍ଜ୍ଵଲା /ଉଜ୍ଵଲା
ഉജ്ജ്വാലാ	ଉଜ୍ଜ୍ଵାଲା
ഉത്കര്ഷ	ଉତ୍କର୍ଷ
ഉത്കലാ	ଉତ୍କଲା
ഉത്തര	ଉତ୍ତର
ഉത്പര	ଉତ୍ପର
ഉത്സര്ഗ	ଉତ୍ସର୍ଗ
ഉദയ കുമാര	ଉଦଯ କୁମାର
ഉദരഥീ	ଉଦରଥୀ
ഉദാന്തികാ	ଉଦାନ୍ତିକା
ഉദേയ	ଉଦେଯ
ഉദ്ധാര	ଉଦ୍ଧାର
ഉദ്യത	ଉଦ୍ଯତ
ഉദ്യമീ	ଉଦ୍ଯମୀ
ഉദ്യോത	ଉଦ୍ଯୋତ
ഉധവ	ଉଧଵ
ഉപംഗ	ଉପଂଗ
ഉപദാ	ଉପଦା
ഉപാധ്രീതീ	ଉପାଧ୍ରୀତୀ
ഉപ്പാസ	ଉପ୍ପାସ
ഉമാ	ଉମା
ഉമേശ്വര	ଉମେଶ୍ଵର
ഉരിശിതാ	ଉରିଶିତା
ഉര്ജാ	ଉର୍ଜା
ഉര്ജീകാ	ଉର୍ଜୀକା
ഉര്ജീതാ	ଉର୍ଜୀତା
ഉര്ദാഹാവ	ଉର୍ଦାହାଵ
ഉര്മികാ	ଉର୍ମିକା
ഉര്മിമാലാ	ଉର୍ମିମାଲା
ഉര്വീനാഥ	ଉର୍ଵୀନାଥ
ഉല്പേശ	ଉଲ୍ପେଶ
ഉശേന്യ	ଉଶେନ୍ଯ
ഉഷാശി	ଉଷାଶି
ഉഷ്മാ	ଉଷ୍ମା
ഉസരീ	ଉସରୀ
ഊതരാ	ଊତରା
ഊര്വേശ	ଊର୍ଵେଶ
ഏകംശീ	ଏକଂଶୀ
ഏകക്ഷരപരാ	ଏକକ୍ଷରପରା
ഏകതന	ଏକତନ
ഏകതാ	ଏକତା
ഏകാംശ	ଏକାଂଶ
ഏകാകാന്യ	ଏକାକାନ୍ଯ
ഏകാനീ	ଏକାନୀ
ഏകാപര്നികാ	ଏକାପର୍ନିକା
ഏകേസ്വാര	ଏକେସ୍ଵାର
ഏത്തന	ଏତ୍ତନ
ഏധിത	ଏଧିତ
ഏമാ	ଏମା
ഏലനാ	ଏଲନା
ഏലാ	ଏଲା
ഏലീലവേംദന	ଏଲୀଲଵେଂଦନ
ഏലീലീ	ଏଲୀଲୀ
ഓഈസീന	ଓଈସୀନ
ഓജസ്വീ	ଓଜସ୍ଵୀ
ഓജാ	ଓଜା
ഓജീസ	ଓଜୀସ
ഓനിശ	ଓନିଶ
ഓമപ്രകാശ	ଓମପ୍ରକାଶ
ഓവീന	ଓଵୀନ
ഓവൈസ	ଓଵୈସ
കംജ	କଂଜ
കംജന	କଂଜନ
കംഠന	କଂଠନ
കംദര്പ	କଂଦର୍ପ
കംപനാ	କଂପନା
കകോന	କକୋନ
കതകീ	କତକୀ
കതേല്യ്ന	କତେଲ୍ଯ୍ନ
കനക	କନକ
കനദ	କନଦ
കനാകംഗീ	କନାକଂଗୀ
കനീജാ	କନୀଜା
കനീരാ	କନୀରା
കനീസാ	କନୀସା
കനുഷ	କନୁଷ
കന്വക	କନ୍ଵକ
കന്ശീകാ	କନ୍ଶୀକା
കപാലീന	କପାଲୀନ
കപിലാശ്വര	କପିଲାଶ୍ଵର
കമലാപതി	କମଲାପତି
കമലിനീ	କମଲିନୀ
കമലേക്ഷണ	କମଲେକ୍ଷଣ
കമ്നാ	କମ୍ନା
കരാലാ	କରାଲା
കരീസമാം	କରୀସମାଂ
കരുനാസ്രീ	କରୁନାସ୍ରୀ
കരുപ്പസമ്യ	କରୁପ୍ପସମ୍ଯ
കര്ണ	କର୍ଣ
കര്തീഗാ	କର୍ତୀଗା
കര്മദീപ	କର୍ମଦୀପ
കര്മാശ	କର୍ମାଶ
കലരനീ	କଲରନୀ
കലശ	କଲଶ
കലാധര	କଲାଧର
കലാനിധി	କଲାନିଧି
കലാപരണ	କଲାପରଣ
കലാപീന	କଲାପୀନ
കലാപ്രിയാ	କଲାପ୍ରିଯା
കലൈസേലവീ	କଲୈସେଲଵୀ
കവന	କଵନ
കവിപ  പ്രിയ	କଵିପ  ପ୍ରିଯ
കവീനാഥ	କଵୀନାଥ
കശ്തീ	କଶ୍ତୀ
കാജല	କାଜଲ
കാജീശ	କାଜୀଶ
കാദമ്ബരീ	କାଦମ୍ବରୀ
കാധിരോലീ	କାଧିରୋଲୀ
കാനീ	କାନୀ
കാന്ജീരാ	କାନ୍ଜୀରା
കാന്തീ	କାନ୍ତୀ
കാമത	କାମତ
കാമിഷാ	କାମିଷା
കാമേശ	କାମେଶ
കാരുണ്യ പ്രകാശ	କାରୁଣ୍ଯ ପ୍ରକାଶ
കാരൂകാ	କାରୂକା
കാര്നിക	କାର୍ନିକ
കാലിക	କାଲିକ
കാലിപദാ	କାଲିପଦା
കാലിയാ	କାଲିଯା
കാലീതാ	କାଲୀତା
കാവ്യ ശ്രീ	କାଵ୍ଯ ଶ୍ରୀ
കിന്നേരാ	କିନ୍ନେରା
കീഅനാ	କୀଅନା
കീജല	କୀଜଲ
കീനാരീ	କୀନାରୀ
കീന്ചനാ	କୀନ୍ଚନା
കേകലാ	କେକଲା
കേതന	କେତନ
കേനിഷാ	କେନିଷା
കേളവ്യ	କେଳଵ୍ଯ
കൈരവീ	କୈରଵୀ
കൈലാശ	କୈଲାଶ
കോശേല	କୋଶେଲ
കൌശികാ	କୌଶିକା
ഖഗേശ	ଖଗେଶ
ഖമീശ	ଖମୀଶ
ഖാതീരാവണ	ଖାତୀରାଵଣ
ഖാത്വന്ഗീന	ଖାତ୍ଵନ୍ଗୀନ
ഖീലതീ	ଖୀଲତୀ
ഖുസീ	ଖୁସୀ
ഗംഗാ	ଗଂଗା
ഗംദേശാ	ଗଂଦେଶା
ഗംധാര	ଗଂଧାର
ഗംധാരാ	ଗଂଧାରା
ഗംധാലീ	ଗଂଧାଲୀ
ഗഗന	ଗଗନ
ഗജവദന	ଗଜଵଦନ
ഗജേന്ദ്ര	ଗଜେନ୍ଦ୍ର
ഗണക	ଗଣକ
ഗണനാ പംഡിതന	ଗଣନା ପଂଡିତନ
ഗണനാഥ	ଗଣନାଥ
ഗണ്യാ	ଗଣ୍ଯା
ഗതി	ଗତି
ഗനേസന	ଗନେସନ
ഗന്ഗസീരുവന	ଗନ୍ଗସୀରୁଵନ
ഗയാലികാ	ଗଯାଲିକା
ഗരിമാ	ଗରିମା
ഗരിഷ്ട	ଗରିଷ୍ଟ
ഗരുല	ଗରୁଲ
ഗാഇശ	ଗାଇଶ
ഗാന്ഗമൈന്ദന	ଗାନ୍ଗମୈନ୍ଦନ
ഗാമിനീ	ଗାମିନୀ
ഗായത്രീ	ଗାଯତ୍ରୀ
ഗായലേ	ଗାଯଲେ
ഗിഅന	ଗିଅନ
ഗിയാ	ଗିଯା
ഗിരിവര	ଗିରିଵର
ഗീതി	ଗୀତି
ഗീതീശാ	ଗୀତୀଶା
ഗുംജാ	ଗୁଂଜା
ഗുനാജാ	ଗୁନାଜା
ഗുനാരത്നാ	ଗୁନାରତ୍ନା
ഗുനാശേകാര	ଗୁନାଶେକାର
ഗുനീന	ଗୁନୀନ
ഗുന്ജീതാ	ଗୁନ୍ଜୀତା
ഗുപ്തക	ଗୁପ୍ତକ
ഗുരദയാല	ଗୁରଦଯାଲ
ഗുരദേവ	ଗୁରଦେଵ
ഗുരബാനീ	ଗୁରବାନୀ
ഗുരമാന	ଗୁରମାନ
ഗുരുത്തമ	ଗୁରୁତ୍ତମ
ഗുര്നാന്ഡീശ	ଗୁର୍ନାନ୍ଡୀଶ
ഗുലമോഹര	ଗୁଲମୋହର
ഗുവീദ	ଗୁଵୀଦ
ഗൂംജീതാ	ଗୂଂଜୀତା
ഗൂഹാരീ	ଗୂହାରୀ
ഗേനേലിയാ	ଗେନେଲିଯା
ഗേശനാ	ଗେଶନା
ഗോപാല	ଗୋପାଲ
ഗോപീ നാഥ	ଗୋପୀ ନାଥ
ഗോഭില	ଗୋଭିଲ
ഗോരഖ-നാഥ	ଗୋରଖ-ନାଥ
ഗൌരവീ	ଗୌରଵୀ
ഗൌരീകാംത	ଗୌରୀକାଂତ
ഗൌരീശ	ଗୌରୀଶ
ഗൌര്പ്രിയാ	ଗୌର୍ପ୍ରିଯା
ഗ്രീതേശ	ଗ୍ରୀତେଶ
ഗ്രീവാ	ଗ୍ରୀଵା
ഗ്രീശ്മീതാ	ଗ୍ରୀଶ୍ମୀତା
ഗ്രീഷ്മ	ଗ୍ରୀଷ୍ମ
ഘടോതകത്ചാ	ଘଟୋତକତ୍ଚା
ചംചലാ	ଚଂଚଲା
ചംദേര്ഭാന	ଚଂଦେର୍ଭାନ
ചംദ്രകാംത	ଚଂଦ୍ରକାଂତ
ചംദ്രകാംതാ	ଚଂଦ୍ରକାଂତା
ചംദ്രചുര	ଚଂଦ୍ରଚୁର
ചംദ്രപുശ്പാ	ଚଂଦ୍ରପୁଶ୍ପା
ചംദ്രപ്രകാശ	ଚଂଦ୍ରପ୍ରକାଶ
ചംദ്രമതി	ଚଂଦ୍ରମତି
ചംദ്രലേഖാ	ଚଂଦ୍ରଲେଖା
ചംദ്രഹാസ	ଚଂଦ୍ରହାସ
ചംദ്രാനന	ଚଂଦ୍ରାନନ
ചംദ്രാഭാ	ଚଂଦ୍ରାଭା
ചംദ്രേശ	ଚଂଦ୍ରେଶ
ചകേശ	ଚକେଶ
ചകോര	ଚକୋର
ചക്ഷസ	ଚକ୍ଷସ
ചതുര	ଚତୁର
ചതുരാ	ଚତୁରା
ചതുര്ഭുജാ	ଚତୁର୍ଭୁଜା
ചതുര്വേദീ	ଚତୁର୍ଵେଦୀ
ചത്രീയാ	ଚତ୍ରୀଯା
ചന്ദ്രകേതു	ଚନ୍ଦ୍ରକେତୁ
ചരണ	ଚରଣ
ചരന്യാ	ଚରନ୍ଯା
ചലാമാ	ଚଲାମା
ചാംദ	ଚାଂଦ
ചാനാസ്യാ	ଚାନାସ୍ଯା
ചാനേ	ଚାନେ
ചാന്ദനികാ	ଚାନ୍ଦନିକା
ചാരുന	ଚାରୁନ
ചാരുവീ	ଚାରୁଵୀ
ചാര്മീ	ଚାର୍ମୀ
ചാര്വീ	ଚାର୍ଵୀ
ചാവ്രിക	ଚାଵ୍ରିକ
ചിത്കലാ	ଚିତ୍କଲା
ചിത്ത	ଚିତ୍ତ
ചിത്തപ്രസാദ	ଚିତ୍ତପ୍ରସାଦ
ചിത്തരംജന	ଚିତ୍ତରଂଜନ
ചിത്തരംജനീ	ଚିତ୍ତରଂଜନୀ
ചിത്രകുന്ധാലാ	ଚିତ୍ରକୁନ୍ଧାଲା
ചിത്രകേതു	ଚିତ୍ରକେତୁ
ചിത്രഗംധാ	ଚିତ୍ରଗଂଧା
ചിത്രബാനാ	ଚିତ୍ରବାନା
ചിത്രമാലാ	ଚିତ୍ରମାଲା
ചിത്രര്ത	ଚିତ୍ରର୍ତ
ചിത്രല	ଚିତ୍ରଲ
ചിത്രലേഖാ	ଚିତ୍ରଲେଖା
ചിത്രാദീപ	ଚିତ୍ରାଦୀପ
ചിത്രീനീ	ଚିତ୍ରୀନୀ
ചിദംബര	ଚିଦଂବର
ചിദാനംദാ	ଚିଦାନଂଦା
ചിനാര	ଚିନାର
ചിന്നാദുരാഈ	ଚିନ୍ନାଦୁରାଈ
ചിമന	ଚିମନ
ചീദാര്ത	ଚୀଦାର୍ତ
ചീന്മയേ	ଚୀନ୍ମଯେ
ചീരുഷ	ଚୀରୁଷ
ചേതന്ദീപ	ଚେତନ୍ଦୀପ
ചേതള	ଚେତଳ
ചേഥാസാ	ଚେଥାସା
ചേമ്മല	ଚେମ୍ମଲ
ചേര്വിക	ଚେର୍ଵିକ
ചേലന	ଚେଲନ
ചേലിയാഁ	ଚେଲିଯାഁ
ചൈതന്യാ	ଚୈତନ୍ଯା
ചൈത്രാ	ଚୈତ୍ରା
ചൈരാവലീ	ଚୈରାଵଲୀ
ഛായാംക	ଛାଯାଂକ
ജക്ഷ	ଜକ୍ଷ
ജക്ഷാനീ	ଜକ୍ଷାନୀ
ജഗതപ്രകാശ	ଜଗତପ୍ରକାଶ
ജഗദഗുരു	ଜଗଦଗୁରୁ
ജഗദമ്ബാ	ଜଗଦମ୍ବା
ജഗനമോഹിനീ	ଜଗନମୋହିନୀ
ജഗന്മയീ	ଜଗନ୍ମଯୀ
ജഗ്വീ	ଜଗ୍ଵୀ
ജഗ്വീര	ଜଗ୍ଵୀର
ജജ്വാല്യാ	ଜଜ୍ଵାଲ୍ଯା
ജടായു	ଜଟାଯୁ
ജനഹിതാ	ଜନହିତା
ജനാദേവ	ଜନାଦେଵ
ജനാവ	ଜନାଵ
ജനിത	ଜନିତ
ജമാംദാഗ്ന്യ മഹാദാര്പാ	ଜମାଂଦାଗ୍ନ୍ଯ ମହାଦାର୍ପା
ജമ്ബവതപ്രീതി	ଜମ୍ବଵତପ୍ରୀତି
ജയംത	ଜଯଂତ
ജയചംദ	ଜଯଚଂଦ
ജയപാല	ଜଯପାଲ
ജയമാലാ	ଜଯମାଲା
ജയശ്രീ	ଜଯଶ୍ରୀ
ജയാകീര്തന	ଜଯାକୀର୍ତନ
ജയാകേതന	ଜଯାକେତନ
ജയാപാദമാം	ଜଯାପାଦମାଂ
ജയായ	ଜଯାଯ
ജയിത	ଜଯିତ
ജയേശ	ଜଯେଶ
ജലദ	ଜଲଦ
ജല്പേശ	ଜଲ୍ପେଶ
ജശവംത	ଜଶଵଂତ
ജസീത്താ	ଜସୀତ୍ତା
ജസ്സീ	ଜସ୍ସୀ
ജാനകീ	ଜାନକୀ
ജാനകീദാസ	ଜାନକୀଦାସ
ജാനകീനാഥ	ଜାନକୀନାଥ
ജാനകീഭൂഷണ	ଜାନକୀଭୂଷଣ
ജാനഹിതാ	ଜାନହିତା
ജാപക	ଜାପକ
ജായിത്രീ	ଜାଯିତ୍ରୀ
ജിനേശ്വര	ଜିନେଶ୍ଵର
ജിഹാന	ଜିହାନ
ജീതേശ	ଜୀତେଶ
ജീന്ദാല	ଜୀନ୍ଦାଲ
ജീവനകലാ	ଜୀଵନକଲା
ജീവനീ	ଜୀଵନୀ
ജീവന്തീനീ	ଜୀଵନ୍ତୀନୀ
ജുഷ്ടി	ଜୁଷ୍ଟି
ജേനീശാ	ଜେନୀଶା
ജേര്ശീകാ	ଜେର୍ଶୀକା
ജൈകാപിശ	ଜୈକାପିଶ
ജൈചരണ	ଜୈଚରଣ
ജൈനീശ	ଜୈନୀଶ
ജൈപ്രകാശ	ଜୈପ୍ରକାଶ
ജൈവംത	ଜୈଵଂତ
ജൈസല	ଜୈସଲ
ജൈഹാസീനീ	ଜୈହାସୀନୀ
ജോംഫീ	ଜୋଂଫୀ
ജോശനീകാ	ଜୋଶନୀକା
ജോശീതാ	ଜୋଶୀତା
ജ്വാലാ	ଜ୍ଵାଲା
ജ്ഹില	ଜ୍ହିଲ
ജ്ഹീണൂക	ଜ୍ହୀଣୂକ
ഝഹനവീ	ଝହନଵୀ
ഝാനീശാ	ଝାନୀଶା
ഝാരാ	ଝାରା
ഝീയാ	ଝୀଯା
ഝേനീശാ	ଝେନୀଶା
ഝ്യാനനീ	ଝ୍ଯାନନୀ
ടീംകു	ଟୀଂକୁ
ഠുമരീ	ଠୁମରୀ
തക്ശീ	ତକ୍ଶୀ
തക്ശീല	ତକ୍ଶୀଲ
തജജ്ഞ	ତଜଜ୍ଞ
തനവീ	ତନଵୀ
തനിഷ്ക	ତନିଷ୍କ
തനുംജാശ്രീ	ତନୁଂଜାଶ୍ରୀ
തനുംശ്കാ	ତନୁଂଶ୍କା
തനോജ	ତନୋଜ
തപസ	ତପସ
തപസ്വിനീ	ତପସ୍ଵିନୀ
തമില  സേല്വീ	ତମିଲ  ସେଲ୍ଵୀ
തമിശ	ତମିଶ
തമോഘ്നാ	ତମୋଘ୍ନା
തമോനഷ	ତମୋନଷ
തരംജോത	ତରଂଜୋତ
തരനീ	ତରନୀ
തരലാ	ତରଲା
തരീനീ	ତରୀନୀ
തരുശ്രീ	ତରୁଶ୍ରୀ
തരൂണീ	ତରୂଣୀ
തവലീന :	ତଵଲୀନ :
തവിഷാ	ତଵିଷା
തസ്യ	ତସ୍ଯ
താക്ഷ്യാ	ତାକ୍ଷ୍ଯା
താജേന്ദര	ତାଜେନ୍ଦର
താനാരുപീ	ତାନାରୁପୀ
താനിയാ	ତାନିଯା
താന്വീഥാ	ତାନ୍ଵୀଥା
താപീ	ତାପୀ
താരികാ	ତାରିକା
താരീനീ	ତାରୀନୀ
താരൂശ	ତାରୂଶ
താലംക	ତାଲଂକ
താലീന	ତାଲୀନ
താലേശ	ତାଲେଶ
താവന	ତାଵନ
താവീശാ	ତାଵୀଶା
തിതലീ	ତିତଲୀ
തിനാശ	ତିନାଶ
തിലക	ତିଲକ
തീഈവ്യേശ	ତୀଈଵ୍ଯେଶ
തീര്ഥാ	ତୀର୍ଥା
തീസ്ചാ	ତୀସ୍ଚା
തുത്തീ	ତୁତ୍ତୀ
തുനാവാ	ତୁନାଵା
തുന്ഗാര	ତୁନ୍ଗାର
തുപമ	ତୁପମ
തുരഗ	ତୁରଗ
തുശീഥാ	ତୁଶୀଥା
തൃപേശ	ତୃପେଶ
തേജസ	ତେଜସ
തേജസ്വീ	ତେଜସ୍ଵୀ
തേജസ്വീന	ତେଜସ୍ଵୀନ
തേജേനദര	ତେଜେନଦର
തേജോമയ	ତେଜୋମଯ
തോയേശ	ତୋଯେଶ
തോശീകാ	ତୋଶୀକା
തൌരുസ	ତୌରୁସ
ത്രികായാ	ତ୍ରିକାଯା
ത്രിപുരസുംദരീ	ତ୍ରିପୁରସୁଂଦରୀ
ത്രിഭുവന	ତ୍ରିଭୁଵନ
ത്രിമാന	ତ୍ରିମାନ
ത്രിമൂര്തി	ତ୍ରିମୂର୍ତି
ത്രിവേണീ	ତ୍ରିଵେଣୀ
ത്രിശല	ତ୍ରିଶଲ
ത്രിശലാനാ	ତ୍ରିଶଲାନା
ത്രീഝ്യാ	ତ୍ରୀଝ୍ଯା
ത്രീതിയാ	ତ୍ରୀତିଯା
ത്രീനേശ	ତ୍ରୀନେଶ
ത്രീപന	ତ୍ରୀପନ
ത്രീപ്ത	ତ୍ରୀପ୍ତ
ത്രീവീദ	ତ୍ରୀଵୀଦ
ത്വരിതാ	ତ୍ଵରିତା
ത്വീശീ	ତ୍ଵୀଶୀ
ത്വേസാ	ତ୍ଵେସା
ഥംസീ	ଥଂସୀ
ഥനീരികാ	ଥନୀରିକା
ഥാകാപ്പന്സ്വാമീ	ଥାକାପ୍ପନ୍ସ୍ଵାମୀ
ഥാരികാ	ଥାରିକା
ഥാവനീ	ଥାଵନୀ
ഥീരീശ്കാ	ଥୀରୀଶ୍କା
ഥുസീഥാ	ଥୁସୀଥା
ഥ്രേശാ	ଥ୍ରେଶା
ദംദാപാനീ	ଦଂଦାପାନୀ
ദക്ഷാഹതാ	ଦକ୍ଷାହତା
ദബീത	ଦବୀତ
ദബ്ന്ശും	ଦବ୍ନ୍ଶୁଂ
ദയാദാ	ଦଯାଦା
ദയാനിതാ	ଦଯାନିତା
ദരഹാസ	ଦରହାସ
ദര്ശ	ଦର୍ଶ
ദര്ശക	ଦର୍ଶକ
ദര്ശികാ	ଦର୍ଶିକା
ദര്ശീനീ	ଦର୍ଶୀନୀ
ദര്സീകാ	ଦର୍ସୀକା
ദശാഗ്രീവാ ശീരോഹരാ	ଦଶାଗ୍ରୀଵା ଶୀରୋହରା
ദശാഗ്രീവാകുലാന്താകാ	ଦଶାଗ୍ରୀଵାକୁଲାନ୍ତାକା
ദശാനന	ଦଶାନନ
ദഹാ	ଦହା
ദാനാസ്വീ	ଦାନାସ୍ଵୀ
ദാനുംശ്രീ	ଦାନୁଂଶ୍ରୀ
ദാന്ദാകാരാന്യ പുന്യകൃതേ	ଦାନ୍ଦାକାରାନ୍ଯ ପୁନ୍ଯକୃତେ
ദാരുല	ଦାରୁଲ
ദാഹക	ଦାହକ
ദികീശംദ	ଦିକୀଶଂଦ
ദിഗീശാ	ଦିଗୀଶା
ദിപംശീ	ଦିପଂଶୀ
ദിപശീകീ	ଦିପଶୀକୀ
ദിപേംദര	ଦିପେଂଦର
ദിപ്താ	ଦିପ୍ତା
ദിബസരീ	ଦିବସରୀ
ദിവീഥാ	ଦିଵୀଥା
ദിവേനാ	ଦିଵେନା
ദീതാ	ଦୀତା
ദീനബംധു	ଦୀନବଂଧୁ
ദീപഥീ	ଦୀପଥୀ
ദീപപ്രഭാ	ଦୀପପ୍ରଭା
ദീപമാലാ	ଦୀପମାଲା
ദീപശിഖാ	ଦୀପଶିଖା
ദീപാംജലി	ଦୀପାଂଜଲି
ദീപാശാ	ଦୀପାଶା
ദീപിത	ଦୀପିତ
ദീവാംശ	ଦୀଵାଂଶ
ദേജ	ଦେଜ
ദേബജ്യോതീ	ଦେବଜ୍ଯୋତୀ
ദേബദാത്താ	ଦେବଦାତ୍ତା
ദേബദ്രിതാ	ଦେବଦ୍ରିତା
ദേബന്ശീ	ଦେବନ୍ଶୀ
ദേയ്വയാനാകാന്തന	ଦେଯ୍ଵଯାନାକାନ୍ତନ
ദേവഗര്ഭാ	ଦେଵଗର୍ଭା
ദേവജ്യോതി	ଦେଵଜ୍ଯୋତି
ദേവദാന	ଦେଵଦାନ
ദേവന്ദ്ര	ଦେଵନ୍ଦ୍ର
ദേവമദാനാ	ଦେଵମଦାନା
ദേവരാജ	ଦେଵରାଜ
ദേവശ്രീ	ଦେଵଶ୍ରୀ
ദേവാംഗനാ	ଦେଵାଂଗନା
ദേവാംഗീ	ଦେଵାଂଗୀ
ദേവാംശു	ଦେଵାଂଶୁ
ദേവാദീത്യാ	ଦେଵାଦୀତ୍ଯା
ദേവാനീ	ଦେଵାନୀ
ദേവാന്ശാ	ଦେଵାନ୍ଶା
ദേവാപ്രിയാ	ଦେଵାପ୍ରିଯା
ദേവാമനോഹാരീ	ଦେଵାମନୋହାରୀ
ദേവീന	ଦେଵୀନ
ദേവീലാല	ଦେଵୀଲାଲ
ദേവേന	ଦେଵେନ
ദേവേശീ	ଦେଵେଶୀ
ദേവ്യഹ്നാന	ଦେଵ୍ଯହ୍ନାନ
ദേശാവംത	ଦେଶାଵଂତ
ദൈത്യാകുലാന്താകാ	ଦୈତ୍ଯାକୁଲାନ୍ତାକା
ദൈവ്യാ	ଦୈଵ୍ଯା
ധക്ശീന്യ	ଧକ୍ଶୀନ୍ଯ
ധനസുഖ	ଧନସୁଖ
ധനാജീ	ଧନାଜୀ
ധനിഷ്ഠ	ଧନିଷ୍ଠ
ധനു	ଧନୁ
ധനുജാ	ଧନୁଜା
ധനേശീ	ଧନେଶୀ
ധന്വികാ	ଧନ୍ଵିକା
ധരമനിഷ്ഠ	ଧରମନିଷ୍ଠ
ധരാമാം	ଧରାମାଂ
ധരാഹാസീനീ	ଧରାହାସୀନୀ
ധരീശ	ଧରୀଶ
ധര്മ  ദുത്ത	ଧର୍ମ  ଦୁତ୍ତ
ധര്മഅധ്യക്ഷ	ଧର୍ମଅଧ୍ଯକ୍ଷ
ധര്മദിത്യ	ଧର୍ମଦିତ୍ଯ
ധര്മദേവ	ଧର୍ମଦେଵ
ധര്ശീതാ	ଧର୍ଶୀତା
ധര്ശീനീ	ଧର୍ଶୀନୀ
ധാമീനീ	ଧାମୀନୀ
ധാരാനീ	ଧାରାନୀ
ധിതി	ଧିତି
ധിതീ	ଧିତୀ
ധീപ്ത്ഹാ	ଧୀପ୍ତ୍ହା
ധീമാഹീ	ଧୀମାହୀ
ധീര്ഥാ	ଧୀର୍ଥା
ധേയാംശീ	ଧେଯାଂଶୀ
ധൈര്യ്യാ	ଧୈର୍ଯ୍ଯା
ധ്യുഥീ	ଧ୍ଯୁଥୀ
ധ്രുമീ	ଧ୍ରୁମୀ
നംദക	ନଂଦକ
നംദു	ନଂଦୁ
നക്ശ	ନକ୍ଶ
നക്സത്രരാജാ	ନକ୍ସତ୍ରରାଜା
നഗമാനീ	ନଗମାନୀ
നടവര	ନଟଵର
നത്രീശാ	ନତ୍ରୀଶା
നദീപ	ନଦୀପ
നഭാ	ନଭା
നഭോമാനീ	ନଭୋମାନୀ
നമന	ନମନ
നമനാ	ନମନା
നയന	ନଯନ
നരേന്ദ്രന	ନରେନ୍ଦ୍ରନ
നരേന്ദ്രനാഥ	ନରେନ୍ଦ୍ରନାଥ
നരേശ	ନରେଶ
നവനീത വിലീപ്തംഗാ	ନଵନୀତ ଵିଲୀପ୍ତଂଗା
നവമ	ନଵମ
നവരംഗ	ନଵରଂଗ
നസീബ	ନସୀବ
നാംബീ	ନାଂବୀ
നാഗനാഥ	ନାଗନାଥ
നാഗപാല	ନାଗପାଲ
നാഗേശ്വരണ	ନାଗେଶ୍ଵରଣ
നാഗൈഃ	ନାଗୈଃ
നാതാഭൈരവീ	ନାତାଭୈରଵୀ
നാതിന	ନାତିନ
നാന്ധീനീ	ନାନ୍ଧୀନୀ
നാന്നാന	ନାନ୍ନାନ
നാഭിതാ	ନାଭିତା
നാഭേംദു	ନାଭେଂଦୁ
നാമത	ନାମତ
നായകീ	ନାଯକୀ
നായാനീ	ନାଯାନୀ
നായാനീകാ	ନାଯାନୀକା
നാലിനികാംത	ନାଲିନିକାଂତ
നാലീനേശയ	ନାଲୀନେଶଯ
നാവീന്യ	ନାଵୀନ୍ଯ
നാവീല	ନାଵୀଲ
നാവ്യാ ദുര്ഗാ	ନାଵ୍ଯା ଦୁର୍ଗା
നാവ്രീതാ	ନାଵ୍ରୀତା
നികാരാ	ନିକାରା
നിഖിതാ	ନିଖିତା
നിഖില	ନିଖିଲ
നിജു	ନିଜୁ
നിധി	ନିଧି
നിധിപാ	ନିଧିପା
നിപാ	ନିପା
നിരംജനാ	ନିରଂଜନା
നിരമഈ	ନିରମଈ
നിരുപമാ	ନିରୁପମା
നിര്മളാ	ନିର୍ମଳା
നിര്മിതി	ନିର୍ମିତି
നിലാശാ	ନିଲାଶା
നിശാനഥീ	ନିଶାନଥୀ
നീഗീഥാ	ନୀଗୀଥା
നീതു	ନୀତୁ
നീഥീകാ	ନୀଥୀକା
നീധാ	ନୀଧା
നീധാര്സനാ	ନୀଧାର୍ସନା
നീമാംലന	ନୀମାଂଲନ
നീരാലികാ	ନୀରାଲିକା
നീരൈമാംഥീ	ନୀରୈମାଂଥୀ
നീര്മുകതാ	ନୀର୍ମୁକତା
നീല മാധവ	ନୀଲ ମାଧଵ
നീലംജന	ନୀଲଂଜନ
നീലക്ഷ	ନୀଲକ୍ଷ
നീല്ജാ	ନୀଲ୍ଜା
നീശാലീ	ନୀଶାଲୀ
നീശീതീ	ନୀଶୀତୀ
നീശ്മീഥാ	ନୀଶ୍ମୀଥା
നീസ്ചീഥാ	ନୀସ୍ଚୀଥା
നീഹാ	ନୀହା
നേമീശാ	ନେମୀଶା
നേയ്സാ	ନେଯ୍ସା
നേരീശാ	ନେରୀଶା
നൈജാ	ନୈଜା
നൈരീതീ	ନୈରୀତୀ
നൈവേധീ	ନୈଵେଧୀ
നൌസദ	ନୌସଦ
പംകജന	ପଂକଜନ
പംചഭൂതാത്മികാ	ପଂଚଭୂତାତ୍ମିକା
പംഥീനീ	ପଂଥୀନୀ
പഝ്ഹേനീ	ପଝ୍ହେନୀ
പത്താമ്ബരാപരീധാനാ	ପତ୍ତାମ୍ବରାପରୀଧାନା
പത്ര	ପତ୍ର
പന്ദാലാവാസന	ପନ୍ଦାଲାଵାସନ
പമ്പാ	ପମ୍ପା
പമ്ഫാ	ପମ୍ଫା
പയാസ	ପଯାସ
പയോധീ	ପଯୋଧୀ
പരംതാപാ	ପରଂତାପା
പരമാംത്മികാ	ପରମାଂତ୍ମିକା
പരമാംന്ത്ര	ପରମାଂନ୍ତ୍ର
പരമിലാ	ପରମିଲା
പരമേശ്വരീ	ପରମେଶ୍ଵରୀ
പരമ്വാര്ദാന	ପରମ୍ଵାର୍ଦାନ
പരവാനീ	ପରଵାନୀ
പരവിംദര	ପରଵିଂଦର
പരാകാഷ	ପରାକାଷ
പരാവീ	ପରାଵୀ
പരിഹാ	ପରିହା
പര്തീബന	ପର୍ତୀବନ
പര്ലീ	ପର୍ଲୀ
പര്വ	ପର୍ଵ
പലാക്ഷ	ପଲାକ୍ଷ
പലാശീനീ	ପଲାଶୀନୀ
പവന	ପଵନ
പവനസുത	ପଵନସୁତ
പശുപതി	ପଶୁପତି
പഹലാജ	ପହଲାଜ
പാടലാ	ପାଟଲା
പാന്ദുരംഗാ	ପାନ୍ଦୁରଂଗା
പായല	ପାଯଲ
പാരു	ପାରୁ
പാര്ഥിക	ପାର୍ଥିକ
പാര്ഥീവീ	ପାର୍ଥୀଵୀ
പാര്ഥോ	ପାର୍ଥୋ
പാളവീ	ପାଳଵୀ
പാവകീ	ପାଵକୀ
പാവനാ	ପାଵନା
പാവാനാ	ପାଵାନା
പാഹീ	ପାହୀ
പിവാല	ପିଵାଲ
പൂജന	ପୂଜନ
പൂരതീ	ପୂରତୀ
പൂരികാ	ପୂରିକା
പൂര്വജാ	ପୂର୍ଵଜା
പൂര്വികാ	ପୂର୍ଵିକା
പേഖമ	ପେଖମ
പേത്ചീ	ପେତ୍ଚୀ
പേരാരസീ	ପେରାରସୀ
പ്രകൃഥീ	ପ୍ରକୃଥୀ
പ്രഗന്യാ	ପ୍ରଗନ୍ଯା
പ്രഗ്യപരാമിതാ	ପ୍ରଗ୍ଯପରାମିତା
പ്രജാനാ	ପ୍ରଜାନା
പ്രനാദാ	ପ୍ରନାଦା
പ്രനീധാനാ	ପ୍ରନୀଧାନା
പ്രബകരണ	ପ୍ରବକରଣ
പ്രഭാകര	ପ୍ରଭାକର
പ്രഭാകരന	ପ୍ରଭାକରନ
പ്രഭാത	ପ୍ରଭାତ
പ്രഭാവ	ପ୍ରଭାଵ
പ്രാതീകാ	ପ୍ରାତୀକା
ഫനീ	ଫନୀ
ഫനീഭുഷണ	ଫନୀଭୁଷଣ
ഫാല്ഗുനീ	ଫାଲ୍ଗୁନୀ
ഫൂലന	ଫୂଲନ
ഫ്രാന്ചീസ	ଫ୍ରାନ୍ଚୀସ
ബംദിശ	ବଂଦିଶ
ബംധൂല	ବଂଧୂଲ
ബംശീ	ବଂଶୀ
ബംസീധര	ବଂସୀଧର
ബകുലാ	ବକୁଲା
ബകൂല	ବକୂଲ
ബദ്രീ	ବଦ୍ରୀ
ബനജ	ବନଜ
ബനവാരീ	ବନଵାରୀ
ബബന	ବବନ
ബബിശ	ବବିଶ
ബര്ഹന	ବର୍ହନ
ബലബീര	ବଲବୀର
ബഹവാസ്യ	ବହଵାସ୍ଯ
ബാബു	ବାବୁ
ബാബുല	ବାବୁଲ
ബാല മുകുന്ദ	ବାଲ ମୁକୁନ୍ଦ
ബാലധി	ବାଲଧି
ബാലാമോഹന	ବାଲାମୋହନ
ബാലാരാജ	ବାଲାରାଜ
ബാലാശംകര	ବାଲାଶଂକର
ബാലു	ବାଲୁ
ബാലേന്ദു	ବାଲେନ୍ଦୁ
ബാസ്കാര	ବାସ୍କାର
ബിനീതാ	ବିନୀତା
ബീനും	ବୀନୁଂ
ബീന്ദുശ്രീ	ବୀନ୍ଦୁଶ୍ରୀ
ബീന്നീകേര	ବୀନ୍ନୀକେର
ബീപുല	ବୀପୁଲ
ബീബീന	ବୀବୀନ
ബീരത	ବୀରତ
ബീഹാന	ବୀହାନ
ബേനീതാ	ବେନୀତା
ബേനും	ବେନୁଂ
ബേലുരമീ	ବେଲୁରମୀ
ബേല്ലീ	ବେଲ୍ଲୀ
ബൈവാവീ	ବୈଵାଵୀ
ബൈസാഖീ	ବୈସାଖୀ
ബ്രീഥ്ഹീ	ବ୍ରୀଥ୍ହୀ
ബ്ലേസ്സീ	ବ୍ଲେସ୍ସୀ
ഭഗവാന	ଭଗଵାନ
ഭദ്രക്ഷ	ଭଦ୍ରକ୍ଷ
ഭദ്രനിധി	ଭଦ୍ରନିଧି
ഭദ്രപ്രിയാ	ଭଦ୍ରପ୍ରିଯା
ഭദ്രിക	ଭଦ୍ରିକ
ഭദ്രീശാ	ଭଦ୍ରୀଶା
ഭവാനീ	ଭଵାନୀ
ഭവ്യരാജ	ଭଵ୍ଯରାଜ
ഭാഗവംതീ	ଭାଗଵଂତୀ
ഭാദരന	ଭାଦରନ
ഭാനുമിത്ര	ଭାନୁମିତ୍ର
ഭാരഥീ	ଭାରଥୀ
ഭാര്ഗവന	ଭାର୍ଗଵନ
ഭാര്ഗവാ	ଭାର୍ଗଵା
ഭാര്ഘവീ	ଭାର୍ଘଵୀ
ഭാര്ദ്ദ്വാജ	ଭାର୍ଦ୍ଦ୍ଵାଜ
ഭാലേംദ്ര	ଭାଲେଂଦ୍ର
ഭാവതീ	ଭାଵତୀ
ഭാവീഗുരും	ଭାଵୀଗୁରୁଂ
ഭാവ്യമ	ଭାଵ୍ଯମ
ഭാശ്വീനീ	ଭାଶ୍ଵୀନୀ
ഭാസു	ଭାସୁ
ഭാസ്കാരീ	ଭାସ୍କାରୀ
ഭാസ്കേര	ଭାସ୍କେର
ഭീമശംകര	ଭୀମଶଂକର
ഭൂദേവ	ଭୂଦେଵ
ഭൂപത	ଭୂପତ
ഭൂപാല	ଭୂପାଲ
ഭൂമാ	ଭୂମା
ഭൂമാം	ଭୂମାଂ
ഭേരേശ	ଭେରେଶ
ഭൈരവീ	ଭୈରଵୀ
മംഗലമ	ମଂଗଲମ
മംഗേശ	ମଂଗେଶ
മംജു  പ്രസന്ന	ମଂଜୁ  ପ୍ରସନ୍ନ
മംജുനാഥ	ମଂଜୁନାଥ
മംജുലാ	ମଂଜୁଲା
മംത	ମଂତ
മംതോഷ	ମଂତୋଷ
മംദിഥാ	ମଂଦିଥା
മംദിരാ	ମଂଦିରା
മകാലീ	ମକାଲୀ
മകുര	ମକୁର
മഗന	ମଗନ
മണികാംത	ମଣିକାଂତ
മദുരാ	ମଦୁରା
മധുനിഷാ	ମଧୁନିଷା
മധുമാംലീ	ମଧୁମାଂଲୀ
മധുരിമാ	ମଧୁରିମା
മധുവംതീ	ମଧୁଵଂତୀ
മനജീത	ମନଜୀତ
മനപ	ମନପ
മനസ്വിന	ମନସ୍ଵିନ
മനാല്പ	ମନାଲ୍ପ
മനീതാ	ମନୀତା
മനീഷ	ମନୀଷ
മനോജ	ମନୋଜ
മനോരനജനീ	ମନୋରନଜନୀ
മനോരിഥാ	ମନୋରିଥା
മന്നത	ମନ୍ନତ
മന്മായീ	ମନ୍ମାଯୀ
മല്ലികാ	ମଲ୍ଲିକା
മഹംത	ମହଂତ
മഹാതപസ്വീ	ମହାତପସ୍ଵୀ
മഹാദുര്ഗാ	ମହାଦୁର୍ଗା
മഹാദേവാ	ମହାଦେଵା
മഹാദേവാദീപുജീതാ	ମହାଦେଵାଦୀପୁଜୀତା
മഹാന്തേശ	ମହାନ୍ତେଶ
മഹാബാലാ	ମହାବାଲା
മഹാസ്വേതാ	ମହାସ୍ଵେତା
മഹിപതി	ମହିପତି
മഹിഷാസുരമര്ദിനീ	ମହିଷାସୁରମର୍ଦିନୀ
മഹീജിത	ମହୀଜିତ
മഹേംദ്രാ	ମହେଂଦ୍ରା
മഹേശ	ମହେଶ
മഹേശനീ	ମହେଶନୀ
മഹേശീ	ମହେଶୀ
മാംതിക	ମାଂତିକ
മാംനീമോഝ്ഹീ	ମାଂନୀମୋଝ୍ହୀ
മാംനുസരീ	ମାଂନୁସରୀ
മാംന്ക്ഷ	ମାଂନ୍କ୍ଷ
മാംന്ഗീരീ	ମାଂନ୍ଗୀରୀ
മാംന്താവ്യാഹ	ମାଂନ୍ତାଵ୍ଯାହ
മാംന്തീകാ	ମାଂନ୍ତୀକା
മാംന്ദീതാ	ମାଂନ୍ଦୀତା
മാംലാമാംകാല മകാന	ମାଂଲାମାଂକାଲ ମକାନ
മാഇല	ମାଇଲ
മാനകാ	ମାନକା
മാനജ	ମାନଜ
മാനശ	ମାନଶ
മാനിക	ମାନିକ
മാനീശീന	ମାନୀଶୀନ
മാനോരിത	ମାନୋରିତ
മാന്കന	ମାନ୍କନ
മാന്ദാവിക	ମାନ୍ଦାଵିକ
മായാ	ମାଯା
മാര്ഗശീ	ମାର୍ଗଶୀ
മാര്ഗീ	ମାର୍ଗୀ
മാര്തംദ	ମାର୍ତଂଦ
മാര്ഥീകാ	ମାର୍ଥୀକା
മാര്യ	ମାର୍ଯ
മാര്യാ	ମାର୍ଯା
മാര്ഷാ	ମାର୍ଷା
മാലാര്കോഡീ	ମାଲାର୍କୋଡୀ
മാലിനീ	ମାଲିନୀ
മാല്ലേശാ	ମାଲ୍ଲେଶା
മാസൂമ	ମାସୂମ
മാസൂമീ	ମାସୂମୀ
മാഹിയാ	ମାହିଯା
മാഹിരാജ	ମାହିରାଜ
മാഹുലീ	ମାହୁଲୀ
മിലീ	ମିଲୀ
മിഹീകാ	ମିହୀକା
മീനാ	ମୀନା
മേധ	ମେଧ
മേധീനീ	ମେଧୀନୀ
മൈത്രായ	ମୈତ୍ରାଯ
മൌലീശാ	ମୌଲୀଶା
മ്യ്ഥിലീ	ମ୍ଯ୍ଥିଲୀ
യംശ	ଯଂଶ
യക്ഷ	ଯକ୍ଷ
യജും	ଯଜୁଂ
യജുസ	ଯଜୁସ
യജ്നേശ	ଯଜ୍ନେଶ
യഥാര്ഥ	ଯଥାର୍ଥ
യദുനംദന	ଯଦୁନଂଦନ
യശസ്വിനീ	ଯଶସ୍ଵିନୀ
യശാശ്രീ	ଯଶାଶ୍ରୀ
യശ്ദീപ	ଯଶ୍ଦୀପ
യശ്മിത	ଯଶ୍ମିତ
യശ്മിതാ	ଯଶ୍ମିତା
യശ്വാര്ധാനാ	ଯଶ୍ଵାର୍ଧାନା
യശ്വീന	ଯଶ୍ଵୀନ
യശ്വീനീ	ଯଶ୍ଵୀନୀ
യസ്വംഥ	ଯସ୍ଵଂଥ
യാക്സീനീ	ଯାକ୍ସୀନୀ
യാഗ്നാകായാ	ଯାଗ୍ନାକାଯା
യാഗ്നീഥാ	ଯାଗ୍ନୀଥା
യാചന	ଯାଚନ
യാതീരാജു	ଯାତୀରାଜୁ
യാദവീ	ଯାଦଵୀ
യാദവേന്ദ്ര	ଯାଦଵେନ୍ଦ୍ର
യാന്തി	ଯାନ୍ତି
യാശ്രീഥാ	ଯାଶ୍ରୀଥା
യാഷ്ക	ଯାଷ୍କ
യാസസ്വീ	ଯାସସ୍ଵୀ
യുഗന്തീകാ	ଯୁଗନ୍ତୀକା
യുഗപ	ଯୁଗପ
യുഗാന്ധര	ଯୁଗାନ୍ଧର
യുതി	ଯୁତି
യുവംശ	ଯୁଵଂଶ
യുവനാഥ	ଯୁଵନାଥ
യുവല	ଯୁଵଲ
യുവാഥീ	ଯୁଵାଥୀ
യുവാന  സൂര്യ	ଯୁଵାନ  ସୂର୍ଯ
യുവ്നീക	ଯୁଵ୍ନୀକ
യേര്രപ്പാ	ଯେର୍ରପ୍ପା
യേശനാ	ଯେଶନା
യേശാസ്വീനീ	ଯେଶାସ୍ଵୀନୀ
യേസസരീ	ଯେସସରୀ
യോഗദേവാ	ଯୋଗଦେଵା
യോഗരാജ	ଯୋଗରାଜ
യോഗാനംദ	ଯୋଗାନଂଦ
യോഗിത	ଯୋଗିତ
യോഗിതാ	ଯୋଗିତା
യോഗിഥ	ଯୋଗିଥ
യോഗേശ്വര	ଯୋଗେଶ୍ଵର
യോഗ്ദീപ	ଯୋଗ୍ଦୀପ
യോത്ശനാ	ଯୋତ୍ଶନା
യോനേന്ദ്ര	ଯୋନେନ୍ଦ୍ର
യോഹ്ശീനീ	ଯୋହ୍ଶୀନୀ
യൌവാനീ	ଯୌଵାନୀ
രംഗനാഥ	ରଂଗନାଥ
രംജന	ରଂଜନ
രംജികാ	ରଂଜିକା
രംജീവ	ରଂଜୀଵ
രഈര്ഥ	ରଈର୍ଥ
രക്ത	ରକ୍ତ
രക്തകമള	ରକ୍ତକମଳ
രക്ഷികാ	ରକ୍ଷିକା
രക്ഷിത	ରକ୍ଷିତ
രഘവാ	ରଘଵା
രഘവേന്ദര	ରଘଵେନ୍ଦର
രഘുനാഥ	ରଘୁନାଥ
രജത	ରଜତ
രജനീശ	ରଜନୀଶ
രജനേശ	ରଜନେଶ
രജീത	ରଜୀତ
രതന	ରତନ
രതാംജലി	ରତାଂଜଲି
രതീക	ରତୀକ
രതുല	ରତୁଲ
രത്നാകര	ରତ୍ନାକର
രത്നാബലീ	ରତ୍ନାବଲୀ
രഥനാ	ରଥନା
രന്യ	ରନ୍ଯ
രന്വിഥാ	ରନ୍ଵିଥା
രബേക	ରବେକ
രമാംസ്വമ്യ	ରମାଂସ୍ଵମ୍ଯ
രമ്ബേശ	ରମ୍ବେଶ
രയാന	ରଯାନ
രര്ശ്മീതാ	ରର୍ଶ୍ମୀତା
രവി കാന്ത	ରଵି କାନ୍ତ
രവികാംത	ରଵିକାଂତ
രവിത	ରଵିତ
രവീജാ	ରଵୀଜା
രവീനാ	ରଵୀନା
രവ്യംകീ	ରଵ୍ଯଂକୀ
രശീലാ	ରଶୀଲା
രസവംത	ରସଵଂତ
രസ്മീന	ରସ୍ମୀନ
രാഈ കുമാര	ରାଈ କୁମାର
രാഖീ	ରାଖୀ
രാഗാവ	ରାଗାଵ
രാഗിനീ	ରାଗିନୀ
രാഗേശ	ରାଗେଶ
രാഗ്വേദ	ରାଗ୍ଵେଦ
രാജക	ରାଜକ
രാജകന്യാ	ରାଜକନ୍ଯା
രാജഗോപാല	ରାଜଗୋପାଲ
രാജയവര്ദന	ରାଜଯଵର୍ଦନ
രാജാ	ରାଜା
രാജാര്ശീ	ରାଜାର୍ଶୀ
രാജികാ	ରାଜିକା
രാജീവ	ରାଜୀଵ
രാജേംദ്രമോഹന	ରାଜେଂଦ୍ରମୋହନ
രാജേശ്വര	ରାଜେଶ୍ଵର
രാജ്യശ്രീ	ରାଜ୍ଯଶ୍ରୀ
രാധാനീ	ରାଧାନୀ
രാനീ	ରାନୀ
രാമ  കീന്കാര	ରାମ  କୀନ୍କାର
രാമഗോപാല	ରାମଗୋପାଲ
രാമചന്ദ്രന	ରାମଚନ୍ଦ୍ରନ
രാമനാരായണ	ରାମନାରାଯଣ
രാമരാ	ରାମରା
രാമരാജ	ରାମରାଜ
രാമാംസുഗ്രീവാ	ରାମାଂସୁଗ୍ରୀଵା
രാമാനംദ	ରାମାନଂଦ
രാമാനുജമ	ରାମାନୁଜମ
രാമോജീ	ରାମୋଜୀ
രാഹിത്യ	ରାହିତ୍ଯ
രാഹീന്യ	ରାହୀନ୍ଯ
രാഹുലരാജ	ରାହୁଲରାଜ
രിദ്ധി	ରିଦ୍ଧି
രീചികാ	ରୀଚିକା
രീതൂ	ରୀତୂ
രീഥേകാ	ରୀଥେକା
രീദേവ	ରୀଦେଵ
രീധമാം	ରୀଧମାଂ
രീഭ്യാ	ରୀଭ୍ଯା
രീശും	ରୀଶୁଂ
രീശ്മേഥാ	ରୀଶ୍ମେଥା
രേഖാ	ରେଖା
രേത്വിക	ରେତ୍ଵିକ
രേധാ	ରେଧା
രേനാ	ରେନା
രേനേശ	ରେନେଶ
രേമാംനീകാ	ରେମାଂନୀକା
രേമീ	ରେମୀ
രേവാതീ	ରେଵାତୀ
രേവീഥാ	ରେଵୀଥା
രേശമീ	ରେଶମୀ
രേശ്വീന	ରେଶ୍ଵୀନ
രേഹാംശീ	ରେହାଂଶୀ
രേഹാനാ	ରେହାନା
രേഹേഈലാ	ରେହେଈଲା
രേഹ്നുഘാ	ରେହ୍ନୁଘା
രൈവത	ରୈଵତ
രൈവതാ	ରୈଵତା
ലംഗീത	ଲଂଗୀତ
ലക്ഷ	ଲକ୍ଷ
ലക്ഷാകീ	ଲକ୍ଷାକୀ
ലക്ഷിതാ	ଲକ୍ଷିତା
ലക്ഷ്മീകാനതമ	ଲକ୍ଷ୍ମୀକାନତମ
ലജ്ജാ	ଲଜ୍ଜା
ലജ്ജാകാ	ଲଜ୍ଜାକା
ലതാ	ଲତା
ലതേശ	ଲତେଶ
ലവപാല	ଲଵପାଲ
ലവലീന	ଲଵଲୀନ
ലഹരീ	ଲହରୀ
ലാക്ശേതാ	ଲାକ୍ଶେତା
ലാജവംതീ	ଲାଜଵଂତୀ
ലാതീശ	ଲାତୀଶ
ലാനീബന	ଲାନୀବନ
ലാഭാ	ଲାଭା
ലാമ്ബോധാര	ଲାମ୍ବୋଧାର
ലാരീനാ	ଲାରୀନା
ലാര്മികാ	ଲାର୍ମିକା
ലാര്രാജ	ଲାର୍ରାଜ
ലാര്ശന	ଲାର୍ଶନ
ലാവനീ	ଲାଵନୀ
ലാവിനാ	ଲାଵିନା
ലീകേശ	ଲୀକେଶ
ലീത്സാ	ଲୀତ୍ସା
ലീനാശാ	ଲୀନାଶା
ലീനീത	ଲୀନୀତ
ലീപാക്ഷീ	ଲୀପାକ୍ଷୀ
ലീപ്സീകാ	ଲୀପ୍ସୀକା
ലീമനാ	ଲୀମନା
ലീലാമഈ	ଲୀଲାମଈ
ലീശാംത	ଲୀଶାଂତ
ലുസിയാ	ଲୁସିଯା
ലേഈവീനാ	ଲେଈଵୀନା
ലേഖീശാ	ଲେଖୀଶା
ലേമാര	ଲେମାର
ലോകനേത്ര	ଲୋକନେତ୍ର
ലോകാജനാനീ	ଲୋକାଜନାନୀ
ലോകാമാത്രീ	ଲୋକାମାତ୍ରୀ
ലോകീഥാ	ଲୋକୀଥା
ലോകേന്ദ്ര	ଲୋକେନ୍ଦ୍ର
ലോഗീനീ	ଲୋଗୀନୀ
ലോഗേശ്വരണ	ଲୋଗେଶ୍ଵରଣ
ലോചനാ	ଲୋଚନା
ലോനാ	ଲୋନା
ലോമാംകേശ	ଲୋମାଂକେଶ
ലോഹിത	ଲୋହିତ
ലോഹിതാശ്വാ	ଲୋହିତାଶ୍ଵା
ലൌക്യ	ଲୌକ୍ଯ
വംദിതാ	ଵଂଦିତା
വംസികൃഷ്ണ	ଵଂସିକୃଷ୍ଣ
വനദ	ଵନଦ
വനമാംഥീ	ଵନମାଂଥୀ
വനസ	ଵନସ
വനിനാധ	ଵନିନାଧ
വന്ജുല	ଵନ୍ଜୁଲ
വപുസ	ଵପୁସ
വയദീശ	ଵଯଦୀଶ
വരലീ	ଵରଲୀ
വരിന	ଵରିନ
വരിയാസ	ଵରିଯାସ
വരുന	ଵରୁନ
വരുനികാ	ଵରୁନିକା
വര്ണിത	ଵର୍ଣିତ
വര്ധമാന	ଵର୍ଧମାନ
വര്ധാനീ	ଵର୍ଧାନୀ
വര്ധീമൈനകാപുജീതാ	ଵର୍ଧୀମୈନକାପୁଜୀତା
വര്നീശാ	ଵର୍ନୀଶା
വര്ശനേയാ	ଵର୍ଶନେଯା
വര്ശീകാ	ଵର୍ଶୀକା
വര്ശീതാ	ଵର୍ଶୀତା
വര്ശീദ	ଵର୍ଶୀଦ
വര്ഷനീ	ଵର୍ଷନୀ
വല്ലികാ	ଵଲ୍ଲିକା
വസംതാ	ଵସଂତା
വസംതീ	ଵସଂତୀ
വസീസതാ	ଵସୀସତା
വസുമിത്ര	ଵସୁମିତ୍ର
വസുസേന	ଵସୁସେନ
വാക്പതി	ଵାକ୍ପତି
വാക്ഷു	ଵାକ୍ଷୁ
വാച്യ	ଵାଚ୍ଯ
വാജ്രക്ഷ	ଵାଜ୍ରକ୍ଷ
വാതത്മാജ	ଵାତତ୍ମାଜ
വാത്സല്യ	ଵାତ୍ସଲ୍ଯ
വാദിവേലും	ଵାଦିଵେଲୁଂ
വാനര	ଵାନର
വാന്ശുല	ଵାନ୍ଶୁଲ
വാമന	ଵାମନ
വാമാംക്ഷീ	ଵାମାଂକ୍ଷୀ
വാമീല	ଵାମୀଲ
വാരനാ	ଵାରନା
വാരുനീ	ଵାରୁନୀ
വാലാരമാംഥീ	ଵାଲାରମାଂଥୀ
വാല്ല്മാംനാലന	ଵାଲ୍ଲ୍ମାଂନାଲନ
വാശു	ଵାଶୁ
വാസുമന	ଵାସୁମନ
വാഹിനീ	ଵାହିନୀ
വികീശാ	ଵିକୀଶା
വിക്ഷിത	ଵିକ୍ଷିତ
വിജയാലക്ഷ്മീ	ଵିଜଯାଲକ୍ଷ୍ମୀ
വിജയാശാനഥീ	ଵିଜଯାଶାନଥୀ
വിജീതാ	ଵିଜୀତା
വിദിശാ	ଵିଦିଶା
വിദ്യാ	ଵିଦ୍ଯା
വിദ്യുല	ଵିଦ୍ଯୁଲ
വിധാഥരീ	ଵିଧାଥରୀ
വിന്ധുജാ	ଵିନ୍ଧୁଜା
വിബാലീ	ଵିବାଲୀ
വിഭാവാ	ଵିଭାଵା
വിഭൂതി	ଵିଭୂତି
വിഭൂഷ	ଵିଭୂଷ
വിയാമര്ശ	ଵିଯାମର୍ଶ
വിരഗനാപതീ	ଵିରଗନାପତୀ
വിരഭാദ്രപ്പാ	ଵିରଭାଦ୍ରପ୍ପା
വിരാജ	ଵିରାଜ
വിലാശീനീ	ଵିଲାଶୀନୀ
വീണാ	ଵୀଣା
വീണാധാരീ	ଵୀଣାଧାରୀ
വേക്രാംത	ଵେକ୍ରାଂତ
വേഗ	ଵେଗ
വേഗവാഹീനീ	ଵେଗଵାହୀନୀ
വേഗീ	ଵେଗୀ
വേണു	ଵେଣୁ
വേത്ത്രീ	ଵେତ୍ତ୍ରୀ
വേത്രിവാല	ଵେତ୍ରିଵାଲ
വേത്രീവേല	ଵେତ୍ରୀଵେଲ
വേദകാര്തിക	ଵେଦକାର୍ତିକ
വേദവല്ലീ	ଵେଦଵଲ୍ଲୀ
വേദാ	ଵେଦା
വേദാ ശ്രീ	ଵେଦା ଶ୍ରୀ
വേധാംത	ଵେଧାଂତ
വേന്കാത്രമണ	ଵେନ୍କାତ୍ରମଣ
വേന്തന	ଵେନ୍ତନ
വേന്നേലാ	ଵେନ୍ନେଲା
വേന്മതീ	ଵେନ୍ମତୀ
വേലു	ଵେଲୁ
വേഹംത	ଵେହଂତ
വൈകുംഠ	ଵୈକୁଂଠ
വൈജീനാഥ	ଵୈଜୀନାଥ
വൈദത	ଵୈଦତ
വൈദേഹീ	ଵୈଦେହୀ
വൈദ്യുംത	ଵୈଦ୍ଯୁଂତ
വൈധേ	ଵୈଧେ
വൈധ്യാത	ଵୈଧ୍ଯାତ
വൈരാഗ	ଵୈରାଗ
വൈരോചന	ଵୈରୋଚନ
വൈശാലീ	ଵୈଶାଲୀ
വൈശ്വീ	ଵୈଶ୍ଵୀ
വൈഷ്ണവീ	ଵୈଷ୍ଣଵୀ
വൈസകാ	ଵୈସକା
സംക്രാംതി	ସଂକ୍ରାଂତି
സംഗമിത്ര	ସଂଗମିତ୍ର
സംഗമീധീരാ	ସଂଗମୀଧୀରା
സംചയ	ସଂଚଯ
സംചീതീ	ସଂଚୀତୀ
സംജേനാ	ସଂଜେନା
സംജോലീ	ସଂଜୋଲୀ
സംതോക	ସଂତୋକ
സംദിപോന	ସଂଦିପୋନ
സംദീപ	ସଂଦୀପ
സംദേശ	ସଂଦେଶ
സംധരാ	ସଂଧରା
സംധ്യാ	ସଂଧ୍ଯା
സംബീതാ	ସଂବୀତା
സംമീതാ	ସଂମୀତା
സംയുക്ത	ସଂଯୁକ୍ତ
സംവിധാ	ସଂଵିଧା
സംവീഥാ	ସଂଵୀଥା
സംസ്കൃതി	ସଂସ୍କୃତି
സംഹിത	ସଂହିତ
സക്ശീന്യാ	ସକ୍ଶୀନ୍ଯା
സഖ്യാ	ସଖ୍ଯା
സഗന	ସଗନ
സഗുനാ	ସଗୁନା
സചിതാ	ସଚିତା
സചിദാനംദ വിഗ്രഹ	ସଚିଦାନଂଦ ଵିଗ୍ରହ
സചേതന	ସଚେତନ
സച്ചിദാനംദാ	ସଚ୍ଚିଦାନଂଦା
സജീത	ସଜୀତ
സജീലീ	ସଜୀଲୀ
സദഗതി	ସଦଗତି
സദഗുനാ	ସଦଗୁନା
സദാശിവ	ସଦାଶିଵ
സദിശ	ସଦିଶ
സപനാ	ସପନା
സപുഷ്പാ	ସପୁଷ୍ପା
സപ്താബീ	ସପ୍ତାବୀ
സപ്തോര്ശീ	ସପ୍ତୋର୍ଶୀ
സമജാ	ସମଜା
സമദര്ശീ	ସମଦର୍ଶୀ
സമഭ്ദ്ധാ	ସମଭ୍ଦ୍ଧା
സമരേശ	ସମରେଶ
സമാംദ്രിതാ	ସମାଂଦ୍ରିତା
സമാംര്ധ	ସମାଂର୍ଧ
സമാജസ	ସମାଜସ
സമാരാസ്യാ	ସମାରାସ୍ଯା
സമിക	ସମିକ
സമിരന	ସମିରନ
സമേംദ്ര	ସମେଂଦ୍ର
സമേശ	ସମେଶ
സമ്പൂര്ണ	ସମ୍ପୂର୍ଣ
സമ്പ്രഥ്യ	ସମ୍ପ୍ରଥ୍ଯ
സമ്പ്രീതീ	ସମ୍ପ୍ରୀତୀ
സമ്രാട	ସମ୍ରାଟ
സമ്രീധ	ସମ୍ରୀଧ
സരസംഗീ	ସରସଂଗୀ
സലീജ	ସଲୀଜ
സഹര്സീതാ	ସହର୍ସୀତା
സഹശ്രദ	ସହଶ୍ରଦ
സഹസ്ത്രജീത	ସହସ୍ତ୍ରଜୀତ
സഹസ്ത്രബാഹു	ସହସ୍ତ୍ରବାହୁ
സഹീത	ସହୀତ
സഹീരാമ	ସହୀରାମ
സഹ്യ	ସହ୍ଯ
സാംജ	ସାଂଜ
സാഇ രാമ	ସାଇ ରାମ
സാഈനാഥ	ସାଈନାଥ
സാചീ	ସାଚୀ
സാജന	ସାଜନ
സാദ്രീശീ	ସାଦ୍ରୀଶୀ
സാദ്വിഥാ	ସାଦ୍ଵିଥା
സാധന	ସାଧନ
സാധ്യാ	ସାଧ୍ଯା
സാനിധ്യ	ସାନିଧ୍ଯ
സാമംതാ	ସାମଂତା
സാമ്ഭാ	ସାମ୍ଭା
സാരണീ	ସାରଣୀ
സാരഥീ	ସାରଥୀ
സാരികാ	ସାରିକା
സാലവീ	ସାଲଵୀ
സാലസാ	ସାଲସା
സൈകത	ସୈକତ
സൈനീത്യ	ସୈନୀତ୍ଯ
സൈന്ധന്യ	ସୈନ୍ଧନ୍ଯ
സൈലീ	ସୈଲୀ
സൈഹാര്സന	ସୈହାର୍ସନ
ഹംസമാലാ	ହଂସମାଲା
ഹംസാവാഥ്യ	ହଂସାଵାଥ୍ଯ
ഹനാര്വീന	ହନାର୍ଵୀନ
ഹനീതാ	ହନୀତା
ഹനുപ	ହନୁପ
ഹനുമാന	ହନୁମାନ
ഹബീതാ	ହବୀତା
ഹമസാദീപികാ	ହମସାଦୀପିକା
ഹമസാനംദീനീ	ହମସାନଂଦୀନୀ
ഹമീര	ହମୀର
ഹരജീത	ହରଜୀତ
ഹരജീവന	ହରଜୀଵନ
ഹരനാധ	ହରନାଧ
ഹരശും	ହରଶୁଂ
ഹരികിശന	ହରିକିଶନ
ഹരിഗംഗാ	ହରିଗଂଗା
ഹരിഗോപാല	ହରିଗୋପାଲ
ഹരിദാസ	ହରିଦାସ
ഹരിദ്വാര	ହରିଦ୍ଵାର
ഹരിപ്രീത	ହରିପ୍ରୀତ
ഹരിമംതീ	ହରିମଂତୀ
ഹരീ	ହରୀ
ഹരേശ്വര	ହରେଶ୍ଵର
ഹര്മീന	ହର୍ମୀନ
ഹര്ഷണ	ହର୍ଷଣ
ഹര്സികാ	ହର୍ସିକା
ഹശ്മീതാ	ହଶ୍ମୀତା
ഹസമുഖ	ହସମୁଖ
ഹസീതാ	ହସୀତା
ഹസ്വീഥാ	ହସ୍ଵୀଥା
ഹാര്ദീനീ	ହାର୍ଦୀନୀ
ഹാര്ശീനീ	ହାର୍ଶୀନୀ
ഹാലിക	ହାଲିକ
ഹിംഡോള	ହିଂଡୋଳ
ഹിംദോലാ	ହିଂଦୋଲା
ഹിതാക്ഷീ	ହିତାକ୍ଷୀ
ഹിതീ	ହିତୀ
ഹിഥീക്സാ	ହିଥୀକ୍ସା
ഹിമാംശു	ହିମାଂଶୁ
ഹിമാക്ഷ	ହିମାକ୍ଷ
ഹിമാലയ	ହିମାଲଯ
ഹിരംയക	ହିରଂଯକ
ഹിരവ	ହିରଵ
ഹിരവാ	ହିରଵା
ഹിരുധായാ	ହିରୁଧାଯା
ഹിവാ	ହିଵା
ഹീരാനമാം	ହୀରାନମାଂ
ഹീരാന്യാപ്രകാഈ	ହୀରାନ୍ଯାପ୍ରକାଈ
ഹീര്നാക്ഷീ	ହୀର୍ନାକ୍ଷୀ
ഹുവീശ്കാ	ହୁଵୀଶ୍କା
ഹൃദയനാഥ	ହୃଦଯନାଥ
ഹേഈദീ	ହେଈଦୀ
ഹേജല	ହେଜଲ
ഹേതാ	ହେତା
ഹേതാശ	ହେତାଶ
ഹേത്ശ്രീ	ହେତ୍ଶ୍ରୀ
ഹേഥാന്ശ്രീ	ହେଥାନ୍ଶ୍ରୀ
ഹേനീത	ହେନୀତ
ഹേനീല	ହେନୀଲ
ഹേമനാഥ	ହେମନାଥ
ഹേമലതാ	ହେମଲତା
ഹേമാ	ହେମା
ഹേമാംദ്രികാ	ହେମାଂଦ୍ରିକା
ഹേമാഗൌരീ	ହେମାଗୌରୀ
ഹേമാനംദ	ହେମାନଂଦ
ഹേമാലാ	ହେମାଲା
ഹേമാവതീ	ହେମାଵତୀ
ഹേമാവാതിനംദന	ହେମାଵାତିନଂଦନ
ഹേമേംദു	ହେମେଂଦୁ
ഹേയന	ହେଯନ
ഹേയാംശ	ହେଯାଂଶ
ഹേരീത	ହେରୀତ
ഹേലീ	ହେଲୀ
ഹോന്നേശാ	ହୋନ୍ନେଶା
ഹോമാ	ହୋମା
ഹ്രീത്വിക	ହ୍ରୀତ୍ଵିକ
ഹ്രീദാന്ക്ഷ	ହ୍ରୀଦାନ୍କ୍ଷ
ഹ്രീധാന	ହ୍ରୀଧାନ
ഹ്രീശന	ହ୍ରୀଶନ
ഹ്രീശാംത	ହ୍ରୀଶାଂତ
ഹ്രീഷിത	ହ୍ରୀଷିତ
ഹ്രുദയ	ହ୍ରୁଦଯ
ഹ്രുശാല	ହ୍ରୁଶାଲ
ഹ്രേയാംശ	ହ୍ରେଯାଂଶ
ഹ്ര്യ്ദയേശ	ହ୍ର୍ଯ୍ଦଯେଶ
#
#
# Territory names from CLDR
അസൻഷൻ ദ്വീപ്	ଅସൻଷൻ ଦ୍ଵୀପ୍
അന്റോറ	ଅନ୍ଡ଼ୋଡ଼
യുണൈറ്റഡ് അറബ് എമിറൈറ്റ്‌സ്	ଯୁଣୈଡ଼୍ଡ଼ଡ୍ ଅଡ଼ବ୍ ଏମିଡ଼ୈଡ଼୍ଡ଼୍‌ସ୍
അഫ്‌ഗാനിസ്ഥാൻ	ଅଫ୍‌ଗାନିସ୍ଥାൻ
ആൻറിഗ്വയും ബർബുഡയും	ଆൻଡ଼ିଗ୍ଵଯୁଂ ବർବୁଡଯୁଂ
ആൻഗ്വില്ല	ଆൻଗ୍ଵିଲ୍ଲ
അൽബേനിയ	ଅൽବେନିଯ
അർമേനിയ	ଅർମେନିଯ
അംഗോള	ଅଂଗୋଳ
അൻറാർട്ടിക്ക	ଅൻଡ଼ାർଟ୍ଟିକ୍କ
അർജൻറീന	ଅർଜൻଡ଼ୀନ
അമേരിക്കൻ സമോവ	ଅମେରିକ୍କൻ ସମୋଵ
ഓസ്ട്രിയ	ଓସ୍ଟ୍ରିଯ
ഓസ്‌ട്രേലിയ	ଓସ୍‌ଟ୍ରେଲିଯ
അറൂബ	ଅଡ଼ୂବ
അലൻഡ് ദ്വീപുകൾ	ଅଲൻଡ୍ ଦ୍ଵୀପୁକൾ
അസർബൈജാൻ	ଅସർବୈଜାൻ
ബോസ്നിയയും ഹെർസഗോവിനയും	ବୋସ୍ନିଯଯୁଂ ହେർସଗୋଵିନଯୁଂ
ബാർബഡോസ്	ବାർବଡୋସ୍
ബംഗ്ലാദേശ്	ବଂଗ୍ଲାଦେଶ୍
ബെൽജിയം	ବେൽଜିଯଂ
ബുർക്കിനാ ഫാസോ	ବୁർକ୍କିନା ଫାସୋ
ബൾഗേറിയ	ବൾଗେଡ଼ିଯ
ബഹ്റിൻ	ବହ୍ଡ଼ିൻ
ബറുണ്ടി	ବଡ଼ୁଣ୍ଟି
ബെനിൻ	ବେନିൻ
സെന്റ് ബാർത്തലമി	ସେନ୍ଡ଼୍ ବାർତ୍ତଲମି
ബർമുഡ	ବർମୁଡ
ബ്രൂണൈ	ବ୍ରୂଣୈ
ബൊളീവിയ	ବୋଳୀଵିଯ
ബൊണെയ്ർ, സിന്റ് യുസ്റ്റേഷ്യസ്, സാബ എന്നിവ	ବୋଣେଯ୍ർ, ସିନ୍ଡ଼୍ ଯୁସ୍ଡ଼୍ଡ଼େଷ୍ଯସ୍, ସାବ ଏନ୍ନିଵ
ബ്രസീൽ	ବ୍ରସୀൽ
ബഹാമാസ്	ବହାମାସ୍
ഭൂട്ടാൻ	ଭୂଟ୍ଟାൻ
ബൗവെട്ട് ദ്വീപ്	ବୗଵେଟ୍ଟ୍ ଦ୍ଵୀପ୍
ബോട്സ്വാന	ବୋଟ୍ସ୍ଵାନ
ബെലറൂസ്	ବେଲଡ଼ୂସ୍
ബെലീസ്	ବେଲୀସ୍
കാനഡ	କାନଡ
കോക്കസ് (കീലിംഗ്) ദ്വീപുകൾ	କୋକ୍କସ୍ (କୀଲିଂଗ୍) ଦ୍ଵୀପୁକൾ
കോംഗോ - കിൻഷാസ	କୋଂଗୋ - କିൻଷାସ
കോംഗോ (DRC)	କୋଂଗୋ (DRC)
സെൻട്രൽ ആഫ്രിക്കൻ റിപ്പബ്ലിക്	ସେൻଟ୍ରൽ ଆଫ୍ରିକ୍କൻ ଡ଼ିପ୍ପବ୍ଲିକ୍
കോംഗോ - ബ്രാസവില്ലി	କୋଂଗୋ - ବ୍ରାସଵିଲ୍ଲି
കോംഗോ (റിപ്പബ്ലിക്ക്)	କୋଂଗୋ (ଡ଼ିପ୍ପବ୍ଲିକ୍କ୍)
സ്വിറ്റ്സർലാൻഡ്	ସ୍ଵିଡ଼୍ଡ଼୍ସർଲାൻଡ୍
കോട്ട് ഡി വാർ	କୋଟ୍ଟ୍ ଡି ଵାർ
ഐവറി കോസ്റ്റ്	ଐଵଡ଼ି କୋସ୍ଡ଼୍ଡ଼୍
കുക്ക് ദ്വീപുകൾ	କୁକ୍କ୍ ଦ୍ଵୀପୁକൾ
ചിലി	ଚିଲି
കാമറൂൺ	କାମଡ଼ୂൺ
ചൈന	ଚୈନ
കൊളംബിയ	କୋଳଂବିଯ
ക്ലിപ്പെർട്ടൻ ദ്വീപ്	କ୍ଲିପ୍ପେർଟ୍ଟൻ ଦ୍ଵୀପ୍
കോസ്റ്ററിക്ക	କୋସ୍ଡ଼୍ଡ଼ଡ଼ିକ୍କ
ക്യൂബ	କ୍ଯୂବ
കേപ്പ് വെർദെ	କେପ୍ପ୍ ଵେർଦେ
കുറാകാവോ	କୁଡ଼ାକାଵୋ
ക്രിസ്മസ് ദ്വീപ്	କ୍ରିସ୍ମସ୍ ଦ୍ଵୀପ୍
സൈപ്രസ്	ସୈପ୍ରସ୍
ചെക്ക് റിപ്പബ്ലിക്	ଚେକ୍କ୍ ଡ଼ିପ୍ପବ୍ଲିକ୍
ജർമനി	ଜർମନି
ഡീഗോ ഗ്രാഷ്യ	ଡୀଗୋ ଗ୍ରାଷ୍ଯ
ദിജിബൗട്ടി	ଦିଜିବୗଟ୍ଟି
ഡെൻമാർക്ക്	ଡେൻମାർକ୍କ୍
ഡൊമിനിക്ക	ଡୋମିନିକ୍କ
ഡൊമിനിക്കൻ റിപ്പബ്ലിക്	ଡୋମିନିକ୍କൻ ଡ଼ିପ୍ପବ୍ଲିକ୍
അൾജീരിയ	ଅൾଜୀରିଯ
സെയൂത്ത ആൻഡ് മെലിയ	ସେଯୂତ୍ତ ଆൻଡ୍ ମେଲିଯ
ഇക്വഡോർ	ଇକ୍ଵଡୋർ
എസ്റ്റോണിയ‍	ଏସ୍ଡ଼୍ଡ଼ୋଣିଯ‍
ഈജിപ്ത്	ଈଜିପ୍ତ୍
പശ്ചിമ സഹാറ	ପଶ୍ଚିମ ସହାଡ଼
എറിത്രിയ	ଏଡ଼ିତ୍ରିଯ
സ്‌പെയിൻ	ସ୍‌ପେଯିൻ
എത്യോപ്യ	ଏତ୍ଯୋପ୍ଯ
യൂറോപ്യൻ യൂണിയൻ	ଯୂଡ଼ୋପ୍ଯൻ ଯୂଣିଯൻ
ഫിൻലാൻഡ്	ଫିൻଲାൻଡ୍
ഫിജി	ଫିଜି
ഫാക്ക്‌ലാന്റ് ദ്വീപുകൾ	ଫାକ୍କ୍‌ଲାନ୍ଡ଼୍ ଦ୍ଵୀପୁକൾ
ഫോക്ക്‌ലാൻഡ് ദ്വീപുകൾ (ഐലാസ് മാൽവിനാസ്)	ଫୋକ୍କ୍‌ଲାൻଡ୍ ଦ୍ଵୀପୁକൾ (ଐଲାସ୍ ମାൽଵିନାସ୍)
മൈക്രോനേഷ്യ	ମୈକ୍ରୋନେଷ୍ଯ
ഫറോ ദ്വീപുകൾ	ଫଡ଼ୋ ଦ୍ଵୀପୁକൾ
ഫ്രാൻസ്	ଫ୍ରାൻସ୍
ഗാബൺ	ଗାବൺ
യുണൈറ്റഡ് കിംഗ്ഡം	ଯୁଣୈଡ଼୍ଡ଼ଡ୍ କିଂଗ୍ଡଂ
ഗ്രനേഡ	ଗ୍ରନେଡ
ജോർജ്ജിയ	ଜୋർଜ୍ଜିଯ
ഫ്രഞ്ച് ഗയാന	ଫ୍ରଞ୍ଚ୍ ଗଯାନ
ഗേൺസി	ଗେൺସି
ഘാന	ଘାନ
ജിബ്രാൾട്ടർ	ଜିବ୍ରାൾଟ୍ଟർ
ഗ്രീൻലാൻറ്	ଗ୍ରୀൻଲାൻଡ଼୍
ഗാംബിയ	ଗାଂବିଯ
ഗിനിയ	ଗିନିଯ
ഗ്വാഡലൂപ്പ്	ଗ୍ଵାଡଲୂପ୍ପ୍
ഇക്വറ്റോറിയൽ ഗിനിയ	ଇକ୍ଵଡ଼୍ଡ଼ୋଡ଼ିଯൽ ଗିନିଯ
ഗ്രീസ്	ଗ୍ରୀସ୍
ദക്ഷിണ ജോർജ്ജിയയും ദക്ഷിണ സാൻഡ്‌വിച്ച് ദ്വീപുകളും	ଦକ୍ଷିଣ ଜୋർଜ୍ଜିଯଯୁଂ ଦକ୍ଷିଣ ସାൻଡ୍‌ଵିଚ୍ଚ୍ ଦ୍ଵୀପୁକଳୁଂ
ഗ്വാട്ടിമാല	ଗ୍ଵାଟ୍ଟିମାଲ
ഗ്വാം	ଗ୍ଵାଂ
ഗിനിയ-ബിസൗ	ଗିନିଯ-ବିସୗ
ഗയാന	ଗଯାନ
ഹോങ്കോങ്ങ് (SAR) ചൈന	ହୋଙ୍କୋଙ୍ଙ୍ (SAR) ଚୈନ
ഹോങ്കോങ്ങ്	ହୋଙ୍କୋଙ୍ଙ୍
ഹിയേർഡും മക്‌ഡൊണാൾഡ് ദ്വീപുകളും	ହିଯେർଡୁଂ ମକ୍‌ଡୋଣାൾଡ୍ ଦ୍ଵୀପୁକଳୁଂ
ഹോണ്ടുറാസ്	ହୋଣ୍ଟୁଡ଼ାସ୍
ക്രൊയേഷ്യ	କ୍ରୋଯେଷ୍ଯ
ഹെയ്തി	ହେଯ୍ତି
ഹംഗറി	ହଂଗଡ଼ି
കാനറി ദ്വീപുകൾ	କାନଡ଼ି ଦ୍ଵୀପୁକൾ
ഇന്തോനേഷ്യ	ଇନ୍ତୋନେଷ୍ଯ
അയർലാൻഡ്	ଅଯർଲାൻଡ୍
ഇസ്രായേൽ	ଇସ୍ରାଯେൽ
ഐൽ ഓഫ് മാൻ	ଐൽ ଓଫ୍ ମାൻ
ഇന്ത്യ	ଇନ୍ତ୍ଯ
ബ്രിട്ടീഷ് ഇന്ത്യൻ മഹാസമുദ്ര പ്രദേശം	ବ୍ରିଟ୍ଟୀଷ୍ ଇନ୍ତ୍ଯൻ ମହାସମୁଦ୍ର ପ୍ରଦେଶଂ
ഇറാഖ്	ଇଡ଼ାଖ୍
ഇറാൻ	ଇଡ଼ାൻ
ഐസ്‌ലാന്റ്	ଐସ୍‌ଲାନ୍ଡ଼୍
ഇറ്റലി	ଇଡ଼୍ଡ଼ଲି
ജേഴ്സി	ଜେଳ଼୍ସି
ജമൈക്ക	ଜମୈକ୍କ
ജോർദ്ദാൻ	ଜୋർଦ୍ଦାൻ
ജപ്പാൻ	ଜପ୍ପାൻ
കെനിയ	କେନିଯ
കിർഗിസ്ഥാൻ	କିർଗିସ୍ଥାൻ
കംബോഡിയ	କଂବୋଡିଯ
കിരിബാട്ടി	କିରିବାଟ୍ଟି
കോമൊറോസ്	କୋମୋଡ଼ୋସ୍
സെന്റ് കിറ്റ്‌സും നെവിസും	ସେନ୍ଡ଼୍ କିଡ଼୍ଡ଼୍‌ସୁଂ ନେଵିସୁଂ
ഉത്തരകൊറിയ	ଉତ୍ତରକୋଡ଼ିଯ
ദക്ഷിണകൊറിയ	ଦକ୍ଷିଣକୋଡ଼ିଯ
കുവൈറ്റ്	କୁଵୈଡ଼୍ଡ଼୍
കേമാൻ ദ്വീപുകൾ	କେମାൻ ଦ୍ଵୀପୁକൾ
കസാഖിസ്ഥാൻ	କସାଖିସ୍ଥାൻ
ലാവോസ്	ଲାଵୋସ୍
ലെബനൻ	ଲେବନൻ
സെൻറ് ലൂസിയ	ସେൻଡ଼୍ ଲୂସିଯ
ലിച്ചൺസ്റ്റൈൻ	ଲିଚ୍ଚൺସ୍ଡ଼୍ଡ଼ୈൻ
ശ്രീലങ്ക	ଶ୍ରୀଲଙ୍କ
ലൈബീരിയ	ଲୈବୀରିଯ
ലെസോതോ	ଲେସୋତୋ
ലിത്വാനിയ	ଲିତ୍ଵାନିଯ
ലക്സംബർഗ്	ଲକ୍ସଂବർଗ୍
ലാറ്റ്വിയ	ଲାଡ଼୍ଡ଼୍ଵିଯ
ലിബിയ	ଲିବିଯ
മൊറോക്കൊ	ମୋଡ଼ୋକ୍କୋ
മൊണാക്കോ	ମୋଣାକ୍କୋ
മൾഡോവ	ମൾଡୋଵ
മോണ്ടെനെഗ്രോ	ମୋଣ୍ଟେନେଗ୍ରୋ
സെൻറ് മാർട്ടിൻ	ସେൻଡ଼୍ ମାർଟ୍ଟିൻ
മഡഗാസ്കർ	ମଡଗାସ୍କർ
മാർഷൽ‍‍ ദ്വീപുകൾ	ମାർଷൽ‍‍ ଦ୍ଵୀପୁକൾ
മാസിഡോണിയ	ମାସିଡୋଣିଯ
മാസിഡോണിയ (FYROM)	ମାସିଡୋଣିଯ (FYROM)
മാലി	ମାଲି
മ്യാൻമാർ (ബർമ്മ)	ମ୍ଯାൻମାർ (ବർମ୍ମ)
മംഗോളിയ	ମଂଗୋଳିଯ
മക്കാവു (SAR) ചൈന	ମକ୍କାଵୁ (SAR) ଚୈନ
മക്കാവു	ମକ୍କାଵୁ
ഉത്തര മറിയാനാ ദ്വീപുകൾ	ଉତ୍ତର ମଡ଼ିଯାନା ଦ୍ଵୀପୁକൾ
മാർട്ടിനിക്ക്	ମାർଟ୍ଟିନିକ୍କ୍
മൗറിറ്റാനിയ	ମୗଡ଼ିଡ଼୍ଡ଼ାନିଯ
മൊണ്ടെസരത്ത്	ମୋଣ୍ଟେସରତ୍ତ୍
മാൾട്ട	ମାൾଟ୍ଟ
മൗറീഷ്യസ്	ମୗଡ଼ୀଷ୍ଯସ୍
മാലിദ്വീപ്	ମାଲିଦ୍ଵୀପ୍
മലാവി	ମଲାଵି
മെക്സിക്കോ	ମେକ୍ସିକ୍କୋ
മലേഷ്യ	ମଲେଷ୍ଯ
മൊസാംബിക്ക്	ମୋସାଂବିକ୍କ୍
നമീബിയ	ନମୀବିଯ
പുതിയ കാലിഡോണിയ	ପୁତିଯ କାଲିଡୋଣିଯ
നൈജർ	ନୈଜർ
നോർഫോക് ദ്വീപ്	ନୋർଫୋକ୍ ଦ୍ଵୀପ୍
നൈജീരിയ	ନୈଜୀରିଯ
നിക്കരാഗ്വ	ନିକ୍କରାଗ୍ଵ
നെതർലാൻഡ്‌സ്	ନେତർଲାൻଡ୍‌ସ୍
നോർവെ	ନୋർଵେ
നേപ്പാൾ	ନେପ୍ପାൾ
നൗറു	ନୗଡ଼ୁ
ന്യൂയി	ନ୍ଯୂଯି
ന്യൂസിലാൻറ്	ନ୍ଯୂସିଲାൻଡ଼୍
ഒമാൻ	ଓମାൻ
പനാമ	ପନାମ
പെറു	ପେଡ଼ୁ
ഫ്രഞ്ച് പോളിനേഷ്യ	ଫ୍ରଞ୍ଚ୍ ପୋଳିନେଷ୍ଯ
പാപ്പുവ ന്യൂ ഗിനിയ	ପାପ୍ପୁଵ ନ୍ଯୂ ଗିନିଯ
ഫിലിപ്പൈൻസ്	ଫିଲିପ୍ପୈൻସ୍
പാക്കിസ്ഥാൻ	ପାକ୍କିସ୍ଥାൻ
പോളണ്ട്	ପୋଳଣ୍ଟ୍
സെന്റ് പിയറിയും മിക്കലണും	ସେନ୍ଡ଼୍ ପିଯଡ଼ିଯୁଂ ମିକ୍କଲଣୁଂ
പിറ്റ്‌കെയ്‌ൻ ദ്വീപുകൾ	ପିଡ଼୍ଡ଼୍‌କେଯ୍‌ൻ ଦ୍ଵୀପୁକൾ
പ്യൂർട്ടോ റിക്കോ	ପ୍ଯୂർଟ୍ଟୋ ଡ଼ିକ୍କୋ
പാലസ്‌തീൻ പ്രദേശങ്ങൾ	ପାଲସ୍‌ତୀൻ ପ୍ରଦେଶଙ୍ଙൾ
പലസ്‌തീൻ	ପଲସ୍‌ତୀൻ
പോർച്ചുഗൽ	ପୋർଚ୍ଚୁଗൽ
പലാവു	ପଲାଵୁ
പരാഗ്വേ	ପରାଗ୍ଵେ
ഖത്തർ	ଖତ୍ତർ
ദ്വീപസമൂഹം	ଦ୍ଵୀପସମୂହଂ
റീയൂണിയൻ	ଡ଼ୀଯୂଣିଯൻ
റൊമാനിയ	ଡ଼ୋମାନିଯ
സെർബിയ	ସେർବିଯ
റഷ്യ	ଡ଼ଷ୍ଯ
റുവാണ്ട	ଡ଼ୁଵାଣ୍ଟ
സൗദി അറേബ്യ	ସୗଦି ଅଡ଼େବ୍ଯ
സോളമൻ‍ ദ്വീപുകൾ	ସୋଳମൻ‍ ଦ୍ଵୀପୁକൾ
സെയ്‌ഷെൽസ്	ସେଯ୍‌ଷେൽସ୍
സുഡാൻ	ସୁଡାൻ
സ്വീഡൻ	ସ୍ଵୀଡൻ
സിംഗപ്പുർ	ସିଂଗପ୍ପୁർ
സെൻറ് ഹെലീന	ସେൻଡ଼୍ ହେଲୀନ
സ്ലോവേനിയ	ସ୍ଲୋଵେନିଯ
സ്വാൽബാഡും ജാൻ മായേനും	ସ୍ଵାൽବାଡୁଂ ଜାൻ ମାଯେନୁଂ
സ്ലോവാക്യ	ସ୍ଲୋଵାକ୍ଯ
സിയെറ ലിയോൺ	ସିଯେଡ଼ ଲିଯୋൺ
സാൻ മറിനോ	ସାൻ ମଡ଼ିନୋ
സെനഗൽ	ସେନଗൽ
സോമാലിയ	ସୋମାଲିଯ
സുരിനെയിം	ସୁରିନେଯିଂ
ദക്ഷിണ സുഡാൻ	ଦକ୍ଷିଣ ସୁଡାൻ
സാവോ ടോമും പ്രിൻസിപെയും	ସାଵୋ ଟୋମୁଂ ପ୍ରିൻସିପେଯୁଂ
എൽ സാൽവദോർ	ଏൽ ସାൽଵଦୋർ
സിന്റ് മാർട്ടെൻ	ସିନ୍ଡ଼୍ ମାർଟ୍ଟେൻ
സിറിയ	ସିଡ଼ିଯ
സ്വാസിലാൻറ്	ସ୍ଵାସିଲାൻଡ଼୍
ട്രസ്റ്റൻ ഡ കൂന	ଟ୍ରସ୍ଡ଼୍ଡ଼ൻ ଡ କୂନ
ടർക്ക്‌സും കെയ്‌ക്കോ ദ്വീപുകളും	ଟർକ୍କ୍‌ସୁଂ କେଯ୍‌କ୍କୋ ଦ୍ଵୀପୁକଳୁଂ
ഛാഡ്	ଛାଡ୍
ഫ്രഞ്ച് ദക്ഷിണ ഭൂപ്രദേശം	ଫ୍ରଞ୍ଚ୍ ଦକ୍ଷିଣ ଭୂପ୍ରଦେଶଂ
ടോഗോ	ଟୋଗୋ
തായ്‌ലാൻഡ്	ତାଯ୍‌ଲାൻଡ୍
താജിക്കിസ്ഥാൻ	ତାଜିକ୍କିସ୍ଥାൻ
ടോക്കെലൂ	ଟୋକ୍କେଲୂ
തിമോർ-ലെസ്റ്റെ	ତିମୋർ-ଲେସ୍ଡ଼୍ଡ଼େ
കിഴക്കൻ തിമോർ	କିଳ଼କ୍କൻ ତିମୋർ
തുർക്ക്മെനിസ്ഥാൻ	ତୁർକ୍କ୍ମେନିସ୍ଥାൻ
ടുണീഷ്യ	ଟୁଣୀଷ୍ଯ
ടോംഗ	ଟୋଂଗ
തുർക്കി	ତୁർକ୍କି
ട്രിനിഡാഡും ടുബാഗോയും	ଟ୍ରିନିଡାଡୁଂ ଟୁବାଗୋଯୁଂ
ടുവാലു	ଟୁଵାଲୁ
തായ്‌വാൻ	ତାଯ୍‌ଵାൻ
ടാൻസാനിയ	ଟାൻସାନିଯ
ഉക്രെയ്‌ൻ	ଉକ୍ରେଯ୍‌ൻ
ഉഗാണ്ട	ଉଗାଣ୍ଟ
അമേരിക്കൻ ഐക്യനാടുകൾ	ଅମେରିକ୍କൻ ଐକ୍ଯନାଟୁକൾ
ഉറുഗ്വേ	ଉଡ଼ୁଗ୍ଵେ
ഉസ്‌ബെക്കിസ്ഥാൻ	ଉସ୍‌ବେକ୍କିସ୍ଥାൻ
വത്തിക്കാൻ	ଵତ୍ତିକ୍କାൻ
സെന്റ് വിൻസെന്റും ഗ്രനെഡൈൻസും	ସେନ୍ଡ଼୍ ଵିൻସେନ୍ଡ଼ୁଂ ଗ୍ରନେଡୈൻସୁଂ
വെനിസ്വേല	ଵେନିସ୍ଵେଲ
ബ്രിട്ടീഷ് വെർജിൻ ദ്വീപുകൾ	ବ୍ରିଟ୍ଟୀଷ୍ ଵେർଜିൻ ଦ୍ଵୀପୁକൾ
വിയറ്റ്നാം	ଵିଯଡ଼୍ଡ଼୍ନାଂ
വന്വാതു	ଵନ୍ଵାତୁ
വാലിസ് ആന്റ് ഫ്യൂച്യുന	ଵାଲିସ୍ ଆନ୍ଡ଼୍ ଫ୍ଯୂଚ୍ଯୁନ
സമോവ	ସମୋଵ
കൊസോവൊ	କୋସୋଵୋ
യെമൻ	ଯେମൻ
മയോട്ടി	ମଯୋଟ୍ଟି
ദക്ഷിണാഫ്രിക്ക	ଦକ୍ଷିଣାଫ୍ରିକ୍କ
സാംബിയ	ସାଂବିଯ
സിംബാബ്‌വേ	ସିଂବାବ୍‌ଵେ
അജ്ഞാത പ്രദേശം	ଅଜ୍ଞାତ ପ୍ରଦେଶଂ
