# Baby names
ਅਂਗਦ	అంగద
ਅਂਗਦ ਦੇਵ	అంగద దేవ
ਅਂਗਾਰਿਕਾ	అంగారికా
ਅਂਤਰਜੋਤ	అంతరజోత
ਅਂਤਰਪ੍ਰਿਤ	అంతరప్రిత
ਅਂਤਰਾ	అంతరా
ਅਕਲਤਟ	అకలతట
ਅਕਲਰੂਪ	అకలరూప
ਅਕਲਸ਼ਰਣ	అకలసరణ
ਅਕਲਸੀਮਾਰ	అకలసీమార
ਅਕਾਲਜੋਗ	అకాలజోగ
ਅਕਾਲਦੀਪ	అకాలదీప
ਅਕਾਲਪ੍ਰੀਤ	అకాలప్రీత
ਅਕਾਲਬੀਰ	అకాలబీర
ਅਗਮਜੀਤ	అగమజీత
ਅਗਮਜੋਤ	అగమజోత
ਅਗਮ੍ਪਾਲ	అగమ్పాల
ਅਗਮ੍ਪ੍ਰੀਤ	అగమ్ప్రీత
ਅਜ੍ਮੀਨ੍ਦੇਰ	అజ్మీన్దేర
ਅਝਾਦਬੀਰ	అఝాదబీర
ਅਝੀਝ	అఝీఝ
ਅਤੀਨਦੇਰ੍ਜਿਤ	అతీనదేర్జిత
ਅਤੀਨ੍ਦੇਰ	అతీన్దేర
ਅਤ੍ਤਾਮਜਿਤ	అత్తామజిత
ਅਨਂਤਦੇਵ	అనంతదేవ
ਅਨਂਤਰ	అనంతర
ਅਨਂਤਵੀਰ	అనంతవీర
ਅਨਂਤ੍ਜੀਤ	అనంత్జీత
ਅਨਾਹਤ	అనాహత
ਅਨਿਂਦਿਤਾ	అనిందితా
ਅਨਿਸ਼ਾ	అనిసా
ਅਨੀਲਜੋਤ	అనీలజోత
ਅਨੀਸ਼੍ਕੋਉਂਰ	అనీస్కోఉంర
ਅਨੁਂਜਪਾਲ	అనుంజపాల
ਅਨੁਂਪਜੋਤ	అనుంపజోత
ਅਨੁਰਾਧਾ	అనురాధా
ਅਨੁਸ਼੍ਕਾ	అనుస్కా
ਅਨੂਪਜੋਤ	అనూపజోత
ਅਨੂਪਬੀਰ	అనూపబీర
ਅਨੂਪਲੋਕ	అనూపలోక
ਅਪੂਰ੍ਵਾ	అపూర్వా
ਅਪ੍ਰੀਨਦੇਰ	అప్రీనదేర
ਅਬਨੀ	అబనీ
ਅਬਿਚਾਲ	అబిచాల
ਅਬਿਨਾਸ਼	అబినాస
ਅਭਿਜੀਤ	అభిజీత
ਅਭਿਰੂਪ	అభిరూప
ਅਮਨਜੀਤ	అమనజీత
ਅਮਰਜੋਤ	అమరజోత
ਅਮਰਤ	అమరత
ਅਮਰਿਂਦਰ	అమరిందర
ਅਮਰਿਤ	అమరిత
ਅਮਲਜੋਤ	అమలజోత
ਅਮਾਨਜੀਵਨ	అమానజీవన
ਅਮਾਨੀਨ੍ਦੇਰ	అమానీన్దేర
ਅਮਾਨ੍ਰੂਪ	అమాన్రూప
ਅਮਾਰ੍ਪਾਲ	అమార్పాల
ਅਮਾਰ੍ਬੀਰ	అమార్బీర
ਅਮਿਕ	అమిక
ਅਮਿਤ	అమిత
ਅਮਿਤੋਜ	అమితోజ
ਅਮੀਤਪਾਲ	అమీతపాల
ਅਮੀਤ੍ਬੀਰ	అమీత్బీర
ਅਮੋਲ੍ਰਸ	అమోల్రస
ਅਮ੍ਨੀਨ੍ਦੇਰ	అమ్నీన్దేర
ਅਮ੍ਰੀਤਬਾਨ	అమ్రీతబాన
ਅਮ੍ਰੀਤ੍ਪ੍ਰਿਤ	అమ్రీత్ప్రిత
ਅਮ੍ਰੀਤ੍ਵਾਨੀ	అమ్రీత్వానీ
ਅਰਮਾਨੀ	అరమానీ
ਅਰਵਜੋਤ	అరవజోత
ਅਰੀਨਾਜੇਤ	అరీనాజేత
ਅਰੀਨ੍ਦੇਰ੍ਜੀਤ	అరీన్దేర్జీత
ਅਰੁਨਜੀਤ	అరునజీత
ਅਰੁਨਜੋਤ	అరునజోత
ਅਰ੍ਚਨਾ	అర్చనా
ਅਰ੍ਦਮਨ	అర్దమన
ਅਰ੍ਨਾਲੀਨ੍ਦੇਰ	అర్నాలీన్దేర
ਅਰ੍ਸ਼੍ਦੀਪ	అర్స్దీప
ਅਲੋਕ੍ਪਾਲ	అలోక్పాల
ਅਲ੍ਪਨਾ	అల్పనా
ਅਵਨੀਨਦੇਰ	అవనీనదేర
ਅਵਿਰ	అవిర
ਅਵ੍ਲੀਨ	అవ్లీన
ਅਸਂਖ	అసంఖ
ਅਸ਼ਮਿਤ	అసమిత
ਅਸ਼ਰ੍ਨਾਮ	అసర్నామ
ਅਸ਼ਰ੍ਪ੍ਰੀਤ	అసర్ప్రీత
ਅਸ਼ਰ੍ਪ੍ਰੇਮ	అసర్ప్రేమ
ਅਸ਼ਰ੍ਵੀਰ	అసర్వీర
ਅਸ਼ਿਮਾ	అసిమా
ਅਸੀਮ	అసీమ
ਅਸੀਸ	అసీస
ਅਸ੍ਨੇਹ	అస్నేహ
ਆਖਰੀ	ఆఖరీ
ਆਤ੍ਮਜਾ	ఆత్మజా
ਆਨਂਦਮਯੀ	ఆనందమయీ
ਆਨਂਦਰੂਪ	ఆనందరూప
ਆਯਕਾਰ	ఆయకార
ਆਯਾਤਪ੍ਰਿਤ	ఆయాతప్రిత
ਆਯੁਸ਼੍ਮਤਿ	ఆయుస్మతి
ਆਰਮਾਨ	ఆరమాన
ਆਰਾਧ	ఆరాధ
ਆਰਾਧਨਾ	ఆరాధనా
ਆਰ੍ਯਨ	ఆర్యన
ਇਂਦਰਬੀਰ	ఇందరబీర
ਇਂਦਿਵਰ	ఇందివర
ਇਕਪ੍ਰਿਤ	ఇకప్రిత
ਇਕਬਾਲ	ఇకబాల
ਇਕਰੂਪ	ఇకరూప
ਇਕ੍ਪੂਜ	ఇక్పూజ
ਇਕ੍ਮਾਨ	ఇక్మాన
ਇਚ੍ਕਜਿਤ	ఇచ్కజిత
ਇਨ੍ਦਾਰਤੇਜ	ఇన్దారతేజ
ਇਨ੍ਦਾਰਮਿਤ	ఇన్దారమిత
ਇਨ੍ਦਾਰ੍ਦੀਪ	ఇన్దార్దీప
ਇਨ੍ਦਾਰ੍ਪ੍ਰਿਤ	ఇన్దార్ప్రిత
ਇਨ੍ਦਾਰ੍ਪ੍ਰੇਮ	ఇన్దార్ప్రేమ
ਇਨ੍ਦੇਰ	ఇన్దేర
ਇਨ੍ਦੇਰਪਲ	ఇన్దేరపల
ਇਨ੍ਦੇਰਮਾਨ	ఇన్దేరమాన
ਇਨ੍ਦੇਰਹਾਰ੍ਜਿਤ	ఇన్దేరహార్జిత
ਇਮਰਾਤ	ఇమరాత
ਈਖ੍ਤਿਅਰ	ఈఖ్తిఅర
ਈਨ੍ਦਰ੍ਜੀਏਤ	ఈన్దర్జీఏత
ਈਨ੍ਦੇਰਤੇਕ	ఈన్దేరతేక
ਈਨ੍ਦੇਰਵੀਰ	ఈన్దేరవీర
ਈਬਾਦਤ	ఈబాదత
ਈਸ਼ਪਾਲ	ఈసపాల
ਈਸ਼ਲੀਨ	ఈసలీన
ਈਸ਼ਾਰਤੇਕ	ఈసారతేక
ਈਸ਼ਾਰਪਾਲ	ఈసారపాల
ਈਸ਼੍ਤ੍ਵਰ੍ਜਿਤ	ఈస్త్వర్జిత
ਈਸ਼੍ਪ੍ਰਿਤ	ఈస్ప్రిత
ਈਸ਼੍ਵਾਰ੍ਜਿਤ	ఈస్వార్జిత
ਈਸ਼੍ਵੀਨਦੇਰ	ఈస్వీనదేర
ਉਖ੍ਤਿਅਰ	ఉఖ్తిఅర
ਉਚਪਾਲ	ఉచపాల
ਉਚਪ੍ਰਿਤ	ఉచప్రిత
ਉਚੀਤਦੀਪ	ఉచీతదీప
ਉਚੀਤਪ੍ਰਿਤ	ఉచీతప్రిత
ਉਚੀਤਬੀਰ	ఉచీతబీర
ਉਚੀਤਰੂਪ	ఉచీతరూప
ਉਚੀਤਲੋਕ	ఉచీతలోక
ਉਚੀਤਵਂਤ	ఉచీతవంత
ਉਜਗਰ੍ਜੋਤ	ఉజగర్జోత
ਉਜਗਰ੍ਦੀਪ	ఉజగర్దీప
ਉਜਗਰ੍ਬੀਰ	ఉజగర్బీర
ਉਜਾਗਰ	ఉజాగర
ਉਜਾਲਾ	ఉజాలా
ਉਜ੍ਜਲਜੋਤ	ఉజ్జలజోత
ਉਤ੍ਤਮ	ఉత్తమ
ਉਤ੍ਤਮਪਾਲ	ఉత్తమపాల
ਉਤ੍ਤਮਲੀਵ	ఉత్తమలీవ
ਉਤ੍ਤਾਮਕਾਰਾਮ	ఉత్తామకారామ
ਉਤ੍ਤਾਮਜੋਧ	ఉత్తామజోధ
ਉਤ੍ਤਾਮਤਿਰਥ	ఉత్తామతిరథ
ਉਤ੍ਤਾਮਤੇਕ	ఉత్తామతేక
ਉਤ੍ਤਾਮਦੀਪ	ఉత్తామదీప
ਉਤ੍ਤਾਮਪਦ	ఉత్తామపద
ਉਤ੍ਤਾਮ੍ਰਸ	ఉత్తామ్రస
ਉਤ੍ਤਾਮ੍ਰੂਪ	ఉత్తామ్రూప
ਉਤ੍ਰਕ੍ਸ਼	ఉత్రక్స
ਉਦੀਤਦੀਪ	ఉదీతదీప
ਉਦੀਤਪ੍ਰਿਤ	ఉదీతప్రిత
ਉਦੀਤਬੀਰ	ఉదీతబీర
ਉਦੈਬੀਰ	ఉదైబీర
ਉਦੈਭਗਤ	ఉదైభగత
ਉਦ੍ਦਾਮਜੀਤ	ఉద్దామజీత
ਉਪਕਰਮ	ఉపకరమ
ਉਪਕਿਰਤ	ఉపకిరత
ਉਪਜਿਤ	ఉపజిత
ਉਪਨਿਤ	ఉపనిత
ਉਪੀਨਦੇਰ੍ਪ੍ਰਿਤ	ఉపీనదేర్ప్రిత
ਉਪੇਨ੍ਦੇਰ	ఉపేన్దేర
ਉਮੀਦ	ఉమీద
ਊਤ੍ਤਮ੍ਗਿਆਨ	ఊత్తమ్గిఆన
ਏਕਂਕਰ	ఏకంకర
ਏਕਬੀਰ	ఏకబీర
ਏਕਮ	ఏకమ
ਏਕਮਪੂਜ	ఏకమపూజ
ਏਕਮਬੀਰ	ఏకమబీర
ਏਕਮ੍ਜੋਤ	ఏకమ్జోత
ਏਕਮ੍ਰੂਪ	ఏకమ్రూప
ਏਕਾਨਪ੍ਰੀਤ	ఏకానప్రీత
ਏਕ੍ਕਾਮ	ఏక్కామ
ਏਤੀਬਾਰ	ఏతీబార
ਏਤ੍ਤਲੀਨ	ఏత్తలీన
ਏਰਸ਼ੀਨ	ఏరసీన
ਏਵੇਨਿਤ	ఏవేనిత
ਏਸ਼ਨਾ	ఏసనా
ਏਸ਼੍ਵਰ	ఏస్వర
ਓਨਕਾਰ੍ਜਿਤ	ఓనకార్జిత
ਓਨਕਾਰ੍ਜੀਤ	ఓనకార్జీత
ਓਨਕਾਰ੍ਪ੍ਰਿਤ	ఓనకార్ప్రిత
ਓਮਪ੍ਰਿਤ	ఓమప్రిత
ਕਂਵਲ	కంవల
ਕਂਵਲਜੀਤ	కంవలజీత
ਕਨਵਾਰ੍ਜਾਗਤ	కనవార్జాగత
ਕਨਵਾਰ੍ਜਿਤ	కనవార్జిత
ਕਨਵਾਰ੍ਪ੍ਰੇਮ	కనవార్ప్రేమ
ਕਨਵਾਲ੍ਜੋਤ	కనవాల్జోత
ਕਨਵਾਲ੍ਨੈਨ	కనవాల్నైన
ਕਨਵਾਲ੍ਪਾਲ	కనవాల్పాల
ਕਨਵਾਲ੍ਪ੍ਰੇਮ	కనవాల్ప్రేమ
ਕਨਵਾਲ੍ਬੀਰ	కనవాల్బీర
ਕਨਵਾਲ੍ਰੂਪ	కనవాల్రూప
ਕਨ੍ਚਨ੍ਦੀਪ	కన్చన్దీప
ਕਨ੍ਚਾਨ੍ਪਾਲ	కన్చాన్పాల
ਕਨ੍ਵਾਰਪਾਲ	కన్వారపాల
ਕਮਾਲ੍ਲਾ	కమాల్లా
ਕਰਨਦੀਪ	కరనదీప
ਕਰਨਪਾਲ	కరనపాల
ਕਰਨਪ੍ਰਿਤ	కరనప్రిత
ਕਰਨਰੂਪ	కరనరూప
ਕਰਮਪਲ	కరమపల
ਕਰਮਪੁਲ	కరమపుల
ਕਰਮ੍ਜੋਤ	కరమ్జోత
ਕਰੁਨ੍ਯਾ	కరున్యా
ਕਲਬੀਰ	కలబీర
ਕਲਾਜੋਤ	కలాజోత
ਕਲਾਪ੍ਰੇਮ	కలాప్రేమ
ਕਵਨਿਤ	కవనిత
ਕਵਨੀਰ	కవనీర
ਕਵਾਲ੍ਨਾਨ	కవాల్నాన
ਕਵਿਰਾਜ	కవిరాజ
ਕਸਮ	కసమ
ਕਾਨਵਾਲੀਨ੍ਦੇਰ	కానవాలీన్దేర
ਕਾਮਾਂਲਜੋਤ	కామాంలజోత
ਕਾਮਾਂਲਮਿਤ	కామాంలమిత
ਕਾਮਾਂਲਮੋਹਨ	కామాంలమోహన
ਕਾਮਾਂਲ੍ਪਤਿ	కామాంల్పతి
ਕਾਰਮਨ	కారమన
ਕਾਵਾਲਪ੍ਰਿਤ	కావాలప్రిత
ਕਿਰਣਜੀਤ	కిరణజీత
ਕਿਰਨਰੂਪ	కిరనరూప
ਕਿਰਨਸੁਖ	కిరనసుఖ
ਕਿਸ਼ੇਨ	కిసేన
ਕੁਂਵਰਜੀਤ	కుంవరజీత
ਕੁਲ	కుల
ਕੁਲਜੋਤ	కులజోత
ਕੁਲਮਿਤ	కులమిత
ਕੁਲਰਾਤਨ	కులరాతన
ਕੁਲਰੂਪ	కులరూప
ਕੁਲਵਂਠ	కులవంఠ
ਕੁਸ਼ਪ੍ਰਿਤ	కుసప్రిత
ਕੇਵਾਲਦੀਪ	కేవాలదీప
ਕੇਵਾਲਬੀਰ	కేవాలబీర
ਕੋਉਰ	కోఉర
ਕੋਮਾਂਲਜੀਤ	కోమాంలజీత
ਕੋਮਾਂਲਪ੍ਰੇਮ	కోమాంలప్రేమ
ਕੋਮਾਲਦੀਪ	కోమాలదీప
ਕੋਮਾਲਮਿਤ	కోమాలమిత
ਕੌਰ	కౌర
ਕ੍ਰਿਸ਼੍ਦੀਪ	క్రిస్దీప
ਕ੍ਸ਼ਾਗਨ	క్సాగన
ਕ੍ਸ਼ਾਗਰ	క్సాగర
ਕ੍ਸ਼ਿਤਿਜ	క్సితిజ
ਕ੍ਸ਼੍ਹੀਮ	క్స్హీమ
ਖਰਗ	ఖరగ
ਖਾਲਾਕ੍ਵੀਰ	ఖాలాక్వీర
ਖੁਂਸ਼ਜੋਤ	ఖుంసజోత
ਖੁਸ	ఖుస
ਖੁਸ਼	ఖుస
ਖੁਸ਼ਜੀਤ	ఖుసజీత
ਖੇਮਵਂਤ	ఖేమవంత
ਗਗਨ	గగన
ਗਗਨਜੀਵ	గగనజీవ
ਗਗਨਜੋਤ	గగనజోత
ਗਗਨਪ੍ਰਿਤ	గగనప్రిత
ਗਗਨਮਿਤ	గగనమిత
ਗਤਲੀਨ	గతలీన
ਗਤਸ਼ਰਣ	గతసరణ
ਗਤਸੀਮਾਰ	గతసీమార
ਗਰੀਨ੍ਦੇਰ	గరీన్దేర
ਗਰ੍ਗੋਤ	గర్గోత
ਗਾਤਨੀਵਾਸ	గాతనీవాస
ਗਿਅਨ	గిఅన
ਗੀਂਜੀਵਨ	గీంజీవన
ਗੀਂਰਾਤਨ	గీంరాతన
ਗੀਂਲੀਨ	గీంలీన
ਗੀਅਂਗੀਤ	గీఅంగీత
ਗੀਅਂਚੇਤਨ	గీఅంచేతన
ਗੀਅਂਜੋਤ	గీఅంజోత
ਗੀਅਂਪ੍ਰਿਤ	గీఅంప్రిత
ਗੀਅਂਰੂਪ	గీఅంరూప
ਗੀਅਨੀਨਦੇਰ	గీఅనీనదేర
ਗੀਅਨ੍ਬੀਰ	గీఅన్బీర
ਗੀਆਨਪ੍ਰਿਤ	గీఆనప్రిత
ਗੀਆਨਲੀਨ	గీఆనలీన
ਗੀਤ	గీత
ਗੀਤਲੀਨ	గీతలీన
ਗੀਤੀਨਦੇਰ	గీతీనదేర
ਗੁਣਿਤ	గుణిత
ਗੁਨ ਦਾਤ	గున దాత
ਗੁਨਕਿਰਤ	గునకిరత
ਗੁਨਜਸ	గునజస
ਗੁਨਜਿਤ	గునజిత
ਗੁਨਜੀਵਨ	గునజీవన
ਗੁਨਜੁਨ	గునజున
ਗੁਨਜੋਤ	గునజోత
ਗੁਨਪ੍ਰਿਤ	గునప్రిత
ਗੁਨਮਿਤ	గునమిత
ਗੁਨਰਾਜ	గునరాజ
ਗੁਨਸ਼ਾਂਤ	గునసాంత
ਗੁਨਾਤਮ	గునాతమ
ਗੁਨਿਤਪੁਲ	గునితపుల
ਗੁਨਿਤਪ੍ਰਿਤ	గునితప్రిత
ਗੁਨ੍ਰਿਤ	గున్రిత
ਗੁਰਕਮਲ਼	గురకమల
ਗੁਰਗਿਯਨ	గురగియన
ਗੁਰਜਾਸ	గురజాస
ਗੁਰਜੀਵਨ	గురజీవన
ਗੁਰਜੋਗ	గురజోగ
ਗੁਰਜੋਤ	గురజోత
ਗੁਰਝੀਲ	గురఝీల
ਗੁਰਤਰਣ	గురతరణ
ਗੁਰਤਿਰਥ	గురతిరథ
ਗੁਰਦਰ੍ਸ਼ਨ	గురదర్సన
ਗੁਰਦਿਤ	గురదిత
ਗੁਰਦੀਤ੍ਤਾ	గురదీత్తా
ਗੁਰਦ੍ਵੀਪ	గురద్వీప
ਗੁਰਨਾਦ	గురనాద
ਗੁਰਨਾਮਾਸ੍ਕਾਰ	గురనామాస్కార
ਗੁਰਨੀਧ	గురనీధ
ਗੁਰਨੀਰ੍ਮਾਲ	గురనీర్మాల
ਗੁਰਨੀਸ਼ਾਨ	గురనీసాన
ਗੁਰਨ੍ਯਮ	గురన్యమ
ਗੁਰਪਰ੍ਵਿਨ	గురపర్విన
ਗੁਰਪੀਨਦੇਰ	గురపీనదేర
ਗੁਰਪ੍ਰੀਤਮ	గురప్రీతమ
ਗੁਰਬਕ੍ਸ਼	గురబక్స
ਗੁਰਬਲੀਹਾਰ	గురబలీహార
ਗੁਰਬੀਨ੍ਦੇਰ	గురబీన్దేర
ਗੁਰਬੀਰ	గురబీర
ਗੁਰਭਜਨ	గురభజన
ਗੁਰਭਾਗਤ	గురభాగత
ਗੁਰਮਾਰ	గురమార
ਗੁਰਮਾਹੇਰ	గురమాహేర
ਗੁਰਮੁਖ	గురముఖ
ਗੁਰਮੇਹਾਰ	గురమేహార
ਗੁਰਮੈਲ	గురమైల
ਗੁਰਮ੍ਰਿਤ	గురమ్రిత
ਗੁਰਲੋਚਨ	గురలోచన
ਗੁਰਵਿਂਦਰ	గురవిందర
ਗੁਰਵੀਨ੍ਦੇਰ	గురవీన్దేర
ਗੁਰਵੀਰ	గురవీర
ਗੁਰਸਨ੍ਦੀਪ	గురసన్దీప
ਗੁਰਸ਼ਾਨ	గురసాన
ਗੁਰਸੁਖ	గురసుఖ
ਗੁਰਸੇਵ	గురసేవ
ਗੁਰਹਾਰ੍ਪਾਲ	గురహార్పాల
ਗੁਰਿਂਦਰ	గురిందర
ਗੁਰੀਨਦੇਰ੍ਪਾਲ	గురీనదేర్పాల
ਗੁਰੁਕਾਰ	గురుకార
ਗੁਰੁਗੁਲ੍ਝਾਰ	గురుగుల్ఝార
ਗੁਰੁਚਰਣ	గురుచరణ
ਗੁਰੁਦਰ੍ਸ਼ਨ	గురుదర్సన
ਗੁਰੁਦਾਸ	గురుదాస
ਗੁਰੁਦੀਪ	గురుదీప
ਗੁਰੁਪ੍ਰੇਮ	గురుప్రేమ
ਗੁਰੁਬੀਰ	గురుబీర
ਗੁਰੁਮਾਂਨ੍ਦੀਰ	గురుమాంన్దీర
ਗੁਰੁਸੀਮ੍ਰਣ	గురుసీమ్రణ
ਗੁਰ੍ਕੀਰਣ	గుర్కీరణ
ਗੁਰ੍ਕੀਰਪਾਲ	గుర్కీరపాల
ਗੁਰ੍ਚਾਰਾਨ੍ਜੋਤ	గుర్చారాన్జోత
ਗੁਰ੍ਜਨਪਾਲ	గుర్జనపాల
ਗੁਰ੍ਜੁ	గుర్జు
ਗੁਰ੍ਤੇਜ	గుర్తేజ
ਗੁਰ੍ਨੀਵਾਝ	గుర్నీవాఝ
ਗੁਰ੍ਨੂਰ	గుర్నూర
ਗੁਰ੍ਪ੍ਰਿਤੀ	గుర్ప్రితీ
ਗੁਰ੍ਮੀਤ	గుర్మీత
ਗੁਰ੍ਮੀਨਦੇਰ	గుర్మీనదేర
ਗੁਰ੍ਮੁਖਨੀਹਲ	గుర్ముఖనీహల
ਗੁਰ੍ਸ਼ਣ	గుర్సణ
ਗੁਰ੍ਸ਼ਾਂਤ	గుర్సాంత
ਗੁਰ੍ਸ਼ੀਲ	గుర్సీల
ਗੁਰ੍ਸਾਹੇਬ	గుర్సాహేబ
ਗੁਲਦੀਪ	గులదీప
ਗੁਲਵਂਤ	గులవంత
ਗੁਲਸ਼ਾਨ੍ਰੂਪ	గులసాన్రూప
ਗੁਲ੍ਵਾਨ੍ਤਪ੍ਰਿਤ	గుల్వాన్తప్రిత
ਗੁਲ੍ਸ਼ਾਨਪ੍ਰਿਤ	గుల్సానప్రిత
ਗੁਲ੍ਸ਼ਾਨਮਿਤ	గుల్సానమిత
ਗੋਪਲਪ੍ਰਿਤ	గోపలప్రిత
ਗੋਬਿਂਦ	గోబింద
ਗੋਬੀਨਦੇਰ	గోబీనదేర
ਗੋਬੀਨਦੇਰ੍ਜਿਤ	గోబీనదేర్జిత
ਗੋਬੀਨ੍ਦਰਾਈ	గోబీన్దరాఈ
ਗੌਰਵ੍ਪ੍ਰਿਤ	గౌరవ్ప్రిత
ਘਮਾਂਨਦ੍ਜਿਤ	ఘమాంనద్జిత
ਘਮਾਂਨਦ੍ਪਾਲ	ఘమాంనద్పాల
ਚਂਚਲਜਿਤ	చంచలజిత
ਚਂਚਲ੍ਪ੍ਰੀਤ	చంచల్ప్రీత
ਚਂਦਨ	చందన
ਚਂਦਨਦੀਪ	చందనదీప
ਚਮਕੌਰ	చమకౌర
ਚਮਨਜਿਤ	చమనజిత
ਚਮਨਪ੍ਰਿਤ	చమనప్రిత
ਚਮਨਰੂਪ	చమనరూప
ਚਰਨਕਾਨ੍ਵਾਲ	చరనకాన్వాల
ਚਰਨਜੋਤ /ਚਰਨਜ੍ਯੋਤ	చరనజోత /చరనజ్యోత
ਚਰਨਪ੍ਰੇਮ	చరనప్రేమ
ਚਾਂਦ	చాంద
ਚਿਤਰਾਮਣ	చితరామణ
ਚਿਤਸਰੂਪ	చితసరూప
ਚੀਤਪ੍ਰਿਤ	చీతప్రిత
ਚੇਤਨ੍ਦੀਪ	చేతన్దీప
ਜਗਜੀਤ	జగజీత
ਜਗਜੀਵ	జగజీవ
ਜਗਜੀਵਨ	జగజీవన
ਜਗਤਜੀਤ	జగతజీత
ਜਗਤਪ੍ਰੇਮ	జగతప్రేమ
ਜਗਤਰਣ	జగతరణ
ਜਗਤਰੂਪ	జగతరూప
ਜਗਨ	జగన
ਜਗਪਾਲ	జగపాల
ਜਗਪ੍ਰਿਤ	జగప్రిత
ਜਗਪ੍ਰੇਮ	జగప్రేమ
ਜਗਮਿਤ	జగమిత
ਜਗਮੇਹਾਰ	జగమేహార
ਜਗਮੋਹਨ	జగమోహన
ਜਗਰਾਜ	జగరాజ
ਜਗਰੂਪ	జగరూప
ਜਗਵੀਨ੍ਦੇਰ	జగవీన్దేర
ਜਗਵੀਰ	జగవీర
ਜਗੀਨਦੇਰ	జగీనదేర
ਜਗੀਨ੍ਦੇਰਪਾਲ	జగీన్దేరపాల
ਜਗ੍ਵੀਰ	జగ్వీర
ਜਘ੍ਰ	జఘ్ర
ਜਤੀਨਦੇਰ੍ਜਿਤ	జతీనదేర్జిత
ਜਤੀਨਦੇਰ੍ਬੀਰ	జతీనదేర్బీర
ਜਤੀਨਦੇਰ੍ਮਿਤ	జతీనదేర్మిత
ਜਨਜਿਤ	జనజిత
ਜਨਜੋਤ	జనజోత
ਜਨਪ੍ਰਿਤ	జనప్రిత
ਜਨਰਾਜ	జనరాజ
ਜਨਿਸ਼	జనిస
ਜਪਜਿਤ	జపజిత
ਜਪਧਾਰਾਮ	జపధారామ
ਜਪਧਿਰ	జపధిర
ਜਪਨਾਮ	జపనామ
ਜਪਸ਼ੇਰ	జపసేర
ਜਪੁਜੀ	జపుజీ
ਜਬਰਜਂਗ	జబరజంగ
ਜਮੀਲ	జమీల
ਜਯਂਸ਼	జయంస
ਜਯਪਾਲ	జయపాల
ਜਰ੍ਨੈਲ	జర్నైల
ਜਲਿਨ੍ਦ੍ਰ	జలిన్ద్ర
ਜਲ੍ਬੀਰ	జల్బీర
ਜਸਂਜੋਤ	జసంజోత
ਜਸਂਪਾਲ	జసంపాల
ਜਸਂਮਿਤ	జసంమిత
ਜਸਕੀਰਣ	జసకీరణ
ਜਸਗੁਰ੍ਕੀਰ੍ਤਤ	జసగుర్కీర్తత
ਜਸਜੀਨ੍ਦੇਰ	జసజీన్దేర
ਜਸਜੀਵਨ	జసజీవన
ਜਸਜੋਤ	జసజోత
ਜਸਤਰਣ	జసతరణ
ਜਸਨਾਮ	జసనామ
ਜਸਪਾਲ (ਪੁਲ )	జసపాల (పుల )
ਜਸਬੀਰ	జసబీర
ਜਸਭੂਪ	జసభూప
ਜਸਮਿਂਦਰ	జసమిందర
ਜਸਮੋਹਨ	జసమోహన
ਜਸਰੂਪ	జసరూప
ਜਸ੍ਕਰਣ	జస్కరణ
ਜਸ੍ਕੀਰਿਤ	జస్కీరిత
ਜਸ੍ਕੀਰ੍ਪਲ	జస్కీర్పల
ਜਸ੍ਗੁਨ	జస్గున
ਜਸ੍ਮਿਤ	జస్మిత
ਜਸ੍ਮੀਨਪ੍ਰਿਤ	జస్మీనప్రిత
ਜਸ੍ਰਜਪ੍ਰਿਤ	జస్రజప్రిత
ਜਸ੍ਸੀ	జస్సీ
ਜਾਗ	జాగ
ਜਾਗਰੀਤ	జాగరీత
ਜਾਤਵਂਤ	జాతవంత
ਜਾਤਿਨਦੇਰ੍ਦੀਪ	జాతినదేర్దీప
ਜਾਨਾਕਪ੍ਰਿਤ	జానాకప్రిత
ਜਾਪਮਾਨ	జాపమాన
ਜਾਸਨਿਤ	జాసనిత
ਜਾਸ਼ਾਨਪ੍ਰਿਤ	జాసానప్రిత
ਜਾਸ੍ਮੀਲ	జాస్మీల
ਜੀਵਨਦੀਪ ; ਜੀਵਨਦੀਪ ; ਜੀਵਨਦੀਪ	జీవనదీప ; జీవనదీప ; జీవనదీప
ਜੀਵਨਪਲ	జీవనపల
ਜੀਵਨਪ੍ਰਿਤ	జీవనప్రిత
ਜੀਵਾਨਬੀਰ	జీవానబీర
ਜੁਗਦ	జుగద
ਜੁਪੀਨਦੇਰਦੀਪ	జుపీనదేరదీప
ਜੁਪੀਨਦੇਰ੍ਬੀਰ	జుపీనదేర్బీర
ਜੁਸਜਿਤ	జుసజిత
ਜੁਸਪੁਲ	జుసపుల
ਜੁਸਮੈਲ	జుసమైల
ਜੇਬਾ	జేబా
ਜੇਸਪਾਲ	జేసపాల
ਜੈਕਾਰ	జైకార
ਜੈਪ੍ਰਜ	జైప్రజ
ਜੈਪ੍ਰਤਨ	జైప్రతన
ਜੈਬੀਰ	జైబీర
ਜੈਸਂਗਤ	జైసంగత
ਜੈਸੁਖਬੀਰ	జైసుఖబీర
ਜੋਗਧੀਆਨ	జోగధీఆన
ਜੋਗਪ੍ਰਕਾਸ਼	జోగప్రకాస
ਜੋਗੀਨਦੇਰ੍ਬੀਰ	జోగీనదేర్బీర
ਜੋਗੀਨਦੇਰ੍ਮਿਤ	జోగీనదేర్మిత
ਜੋਗੇਨਦੇਰ	జోగేనదేర
ਜੋਤਪ੍ਰਕਾਸ਼	జోతప్రకాస
ਜੋਬਨਰੂਪ	జోబనరూప
ਜੋਹਾਰ	జోహార
ਜ੍ਞਾਨਜਿਤ	జ్ఞానజిత
ਜ੍ਞਾਨਜੋਤ	జ్ఞానజోత
ਜ੍ਞਾਨਪ੍ਰਿਤ	జ్ఞానప్రిత
ਜ੍ਞਾਨਰੂਪ	జ్ఞానరూప
ਜ੍ਞਾਨਵੀਰ	జ్ఞానవీర
ਜ੍ਞਾਨੇਨ੍ਦੇਰ	జ్ఞానేన్దేర
ਜ੍ਹਮਕ	జ్హమక
ਜ੍ਹਾਗਰ	జ్హాగర
ਝਈਤੂਨ	ఝఈతూన
ਝਹਾਗਨ	ఝహాగన
ਝਾਮੀਨਾਹ	ఝామీనాహ
ਝੀਤੁਨ	ఝీతున
ਝੀਲ	ఝీల
ਝੁਲਾਖਾ	ఝులాఖా
ਝੁਲ੍ਫਾ	ఝుల్ఫా
ਝੇਬਵਂਤ	ఝేబవంత
ਝੋਰਾਵਾਰ	ఝోరావార
ਟੇਇਜਿਨ੍ਦੇਰ	టేఇజిన్దేర
ਤਕਦੀਰ	తకదీర
ਤਖਤ	తఖత
ਤਤਜੋਗ	తతజోగ
ਤਤਬੀਰ	తతబీర
ਤਤਵਿਚਾਰ	తతవిచార
ਤਤ੍ਰਾਤਨ	తత్రాతన
ਤਦਬੀਰ	తదబీర
ਤਨਦੀਪ	తనదీప
ਤਨਵੀਰ	తనవీర
ਤਮਨ੍ਪ੍ਰਿਤ	తమన్ప్రిత
ਤਰਣਵੀਰ	తరణవీర
ਤਰਲੋਚਨ	తరలోచన
ਤਰਸੇਮ	తరసేమ
ਤਰੁਨਜਿਤ	తరునజిత
ਤਲਵਿਨ	తలవిన
ਤਾਜਦਾਰ	తాజదార
ਤਾਜੀਨਦੇਰ੍ਦੀਪ	తాజీనదేర్దీప
ਤਾਜੀਨਦੇਰ੍ਪ੍ਰੇਮ	తాజీనదేర్ప్రేమ
ਤਾਨੁਪ੍ਰਿਤ	తానుప్రిత
ਤਾਪਨਪਾਲ	తాపనపాల
ਤੀਰਨ /ਤਿਹ੍ਰਣ /ਤੇਯ੍ਰੁਣ	తీరన /తిహ్రణ /తేయ్రుణ
ਤੀਰਾਥ੍ਰਾਮ	తీరాథ్రామ
ਤੁਵਿਜਾਤ	తువిజాత
ਤੇਕਜੀਤ	తేకజీత
ਤੇਕਦੀਪ	తేకదీప
ਤੇਕਪ੍ਰਿਤ	తేకప్రిత
ਤੇਕ੍ਪਾਲ	తేక్పాల
ਤੇਘਬਹਾਦੁਰ	తేఘబహాదుర
ਤੇਜਧਾਰਾਮ	తేజధారామ
ਤੇਜਨਾਮ	తేజనామ
ਤੇਜਪ੍ਰਤਾਪ	తేజప్రతాప
ਤੇਜ਼	తేజ
ਤੇਜਾਸਵੀਰ	తేజాసవీర
ਤੇਜੀਨਦੇਰ੍ਜੀਤ	తేజీనదేర్జీత
ਤੇਜੀਨਦੇਰ੍ਪਾਲ	తేజీనదేర్పాల
ਤੋਤਾਸਿਂਹ	తోతాసింహ
ਤ੍ਰਿਪਲ	త్రిపల
ਤ੍ਰਿਲੋਚਨ	త్రిలోచన
ਤ੍ਰੀਭਾਵਾਨ	త్రీభావాన
ਤ੍ਰੀਸ਼ਾਨਜੋਤ	త్రీసానజోత
ਤ੍ਰੀਸ਼ਾਨਦੀਪ	త్రీసానదీప
ਤ੍ਰੀਸ਼ਾਨਬੀਰ	త్రీసానబీర
ਥਾਕੁਰਨਾਮ	థాకురనామ
ਥਾਲਭੂਪ	థాలభూప
ਥਾਲਰਾਜ	థాలరాజ
ਥੀਰਮਾਨ	థీరమాన
ਥੀਰ੍ਧੀਆਨ	థీర్ధీఆన
ਦਮਨਜਿਤ	దమనజిత
ਦਮਨਜੋਤ	దమనజోత
ਦਯਾਜੋਤ	దయాజోత
ਦਯਾਦੀਪ	దయాదీప
ਦਰਮੀਨ੍ਦੇਰ	దరమీన్దేర
ਦਰ੍ਪ੍ਰਿਤ	దర్ప్రిత
ਦਲਜੋਧ	దలజోధ
ਦਲਬੀਨਦੇਰ	దలబీనదేర
ਦਲਬੀਨ੍ਦੇਰ੍ਜਿਤ	దలబీన్దేర్జిత
ਦਲਰਾਜ	దలరాజ
ਦਲੇਰ	దలేర
ਦਵੀਨ੍ਦੇਰ	దవీన్దేర
ਦਿਦਾਰ	దిదార
ਦਿਨਤੇਕ	దినతేక
ਦਿਪਲੀਨ	దిపలీన
ਦਿਲਜੋਤ	దిలజోత
ਦਿਲਨਿਤ	దిలనిత
ਦਿਲਪ੍ਰਿਤ	దిలప్రిత
ਦਿਲਮਿਤ	దిలమిత
ਦਿਲਰਿਤ	దిలరిత
ਦਿਲਸ਼ਾਨ	దిలసాన
ਦਿਲਸ਼ੇਰ	దిలసేర
ਦਿਵ੍ਯਜ੍ਯੋਤ	దివ్యజ్యోత
ਦੀਲਜੀਤ	దీలజీత
ਦੀਲਬਾਘ	దీలబాఘ
ਦੀਲ੍ਜਿਤ	దీల్జిత
ਦੀਵ੍ਯਜੋਤ	దీవ్యజోత
ਦੇਵਜੀਤ	దేవజీత
ਦੇਵਪ੍ਰਿਤ	దేవప్రిత
ਦੇਵਾਤ੍ਮਾ	దేవాత్మా
ਦੇਵੀਨ੍ਦੇਰ	దేవీన్దేర
ਧਰਮਜ੍ਯੋਤ	ధరమజ్యోత
ਧਰਮਪਾਲ	ధరమపాల
ਧਰਮਪ੍ਰੀਤ	ధరమప్రీత
ਧਰਮਲੀਨ	ధరమలీన
ਧੀਅਨ੍ਜੋਗ	ధీఅన్జోగ
ਨਕ੍ਸ਼ਤ੍ਰਾ	నక్సత్రా
ਨਮ੍ਰੀਤਾਬੀਰ	నమ్రీతాబీర
ਨਯਨਦੀਪ	నయనదీప
ਨਰਿਨ੍ਦਰ	నరిన్దర
ਨਰੇਨ੍ਦ੍ਰ	నరేన్ద్ర
ਨਵਜੀਤ	నవజీత
ਨਵਜੀਵਨ	నవజీవన
ਨਵਦੀਪ	నవదీప
ਨਵਬੀਰ	నవబీర
ਨਵਮਿਤ	నవమిత
ਨਵ੍ਜੀਨ੍ਦੇਰ	నవ్జీన్దేర
ਨਾਗਂਦਰ	నాగందర
ਨਾਨਕੀ	నానకీ
ਨਾਨਵੀਰ	నానవీర
ਨਾਨ੍ਦਾਨਜਿਤ	నాన్దానజిత
ਨਾਨ੍ਦਾਨਪ੍ਰਿਤ	నాన్దానప్రిత
ਨਾਮਜੀਵ	నామజీవ
ਨਾਮਜੋਗ	నామజోగ
ਨਾਮਜੋਤ	నామజోత
ਨਾਮਜੋਧ	నామజోధ
ਨਾਮਧਾਰ	నామధార
ਨਾਮਧਿਯਨ	నామధియన
ਨਾਮਧਿਰ	నామధిర
ਨਾਮਨੀਰ੍ਮਾਲ	నామనీర్మాల
ਨਾਮਨੀਵਾਸ	నామనీవాస
ਨਾਮਪ੍ਰਿਤ	నామప్రిత
ਨਾਮਪ੍ਰੇਮ	నామప్రేమ
ਨਾਮਭਾਗਤ	నామభాగత
ਨਾਮਵਿਚਾਰ	నామవిచార
ਨਾਮਸ਼ਰਣ	నామసరణ
ਨਾਮਾਂਡੋਲ਼	నామాండోల
ਨਾਮਾਹਾਰ	నామాహార
ਨਾਮੁਤ੍ਤਮ	నాముత్తమ
ਨਾਮ੍ਰਾਤਨ	నామ్రాతన
ਨਾਮ੍ਰਿਤਾ	నామ్రితా
ਨਾਮ੍ਰੀਤਾਜੋਤ	నామ్రీతాజోత
ਨਾਮ੍ਰੀਤਾਦੀਪ	నామ్రీతాదీప
ਨਾਮ੍ਰੀਤਾਪ੍ਰਿਤ	నామ్రీతాప్రిత
ਨਾਰ	నార
ਨਾਰਂਜਨ	నారంజన
ਨਾਰੀਤਪਲ	నారీతపల
ਨਾਰੀਨਦੇਰਦੀਪ	నారీనదేరదీప
ਨਾਰੈਨ	నారైన
ਨਾਵਿਨਜਿਤ	నావినజిత
ਨਾਵ੍ਕੀਰਣ	నావ్కీరణ
ਨਾਵ੍ਕੀਰਨਜੋਤ	నావ్కీరనజోత
ਨਾਵ੍ਪ੍ਰਿਤ	నావ్ప్రిత
ਨਿਮਾਈ	నిమాఈ
ਨਿਰਂਜਨ	నిరంజన
ਨਿਰਂਜਨਾ	నిరంజనా
ਨਿਰ੍ਮਲਜੀਤ	నిర్మలజీత
ਨਿਲਾਮਜੋਤ	నిలామజోత
ਨਿਲਾਮਪੁਲ	నిలామపుల
ਨਿਲਾਮਪ੍ਰਿਤ	నిలామప్రిత
ਨਿਲਾਮਬੇਰ	నిలామబేర
ਨਿਸ਼ਾ	నిసా
ਨਿਹ੍ਚਾਲਤੇਕ	నిహ్చాలతేక
ਨਿਹ੍ਚਾਲਮਿਤ	నిహ్చాలమిత
ਨੀਤਨਾਮ	నీతనామ
ਨੀਨਦੇਰ੍ਬੀਰ	నీనదేర్బీర
ਨੀਮਮਾਂਪ੍ਰਿਤ	నీమమాంప్రిత
ਨੀਮਮਾਂਰ੍ਦੀਪ	నీమమాంర్దీప
ਨੀਮ੍ਮਾਂਰਤਾ	నీమ్మాంరతా
ਨੀਮ੍ਰਤ	నీమ్రత
ਨੀਰਮਾਂਲਦੀਪ	నీరమాంలదీప
ਨੀਰਮਾਂਲਬੀਰ	నీరమాంలబీర
ਨੀਰਮੋਲ	నీరమోల
ਨੀਰਵੈਰ	నీరవైర
ਨੀਰ੍ਭਾਉ	నీర్భాఉ
ਨੀਰ੍ਮਾਂਲਕਾਰਾਮ	నీర్మాంలకారామ
ਨੀਰ੍ਮਾਂਲਜੀਵ	నీర్మాంలజీవ
ਨੀਰ੍ਮਾਂਲਜੋਤ	నీర్మాంలజోత
ਨੀਰ੍ਮਾਂਲਤੇਕ	నీర్మాంలతేక
ਨੀਰ੍ਮਾਂਲਧਾਰਾਮ	నీర్మాంలధారామ
ਨੀਰ੍ਮਾਂਲਪ੍ਰਿਤ	నీర్మాంలప్రిత
ਨੀਸ਼ਾਨ੍ਦੀਪ	నీసాన్దీప
ਨੀਹ੍ਚਾਲ੍ਪ੍ਰੇਮ	నీహ్చాల్ప్రేమ
ਨੂਰਦੇਵ	నూరదేవ
ਨੂਰਨਿਤ	నూరనిత
ਨੂਰਪ੍ਰਿਤ	నూరప్రిత
ਨੇਕਨਾਮ	నేకనామ
ਨੇਕੀਨਦੇਰ	నేకీనదేర
ਨੇਕ੍ਦੀਪ	నేక్దీప
ਨੇਕ੍ਪਾਲ	నేక్పాల
ਨੇਹ੍ਚਾਲਪ੍ਰਿਤ	నేహ్చాలప్రిత
ਨੈਨਤਾਰ	నైనతార
ਨੈਨਦੀਪ	నైనదీప
ਨੈਨੀਨਦੇਰ	నైనీనదేర
ਨੋਉਲਖ	నోఉలఖ
ਨੌਹਨੀਹਲ	నౌహనీహల
ਨ੍ਰੀਪਜੋਤ	న్రీపజోత
ਪਤਵਂਤ	పతవంత
ਪਤਵੀਰ	పతవీర
ਪਦਾਮਜਿਤ	పదామజిత
ਪਦਾਮਪ੍ਰੇਮ	పదామప్రేమ
ਪਦ੍ਮਸ਼੍ਰੀ	పద్మస్రీ
ਪਰਤਾਪ ; ਪਰਤਾਪ	పరతాప ; పరతాప
ਪਰਤਾਪੀ	పరతాపీ
ਪਰਦੀਪ	పరదీప
ਪਰਬੀਨ	పరబీన
ਪਰਮਕਮਲ਼	పరమకమల
ਪਰਮਕਿਰਤ	పరమకిరత
ਪਰਮਗੁਨ	పరమగున
ਪਰਮਜਾਪ	పరమజాప
ਪਰਮਜੀਤ ; ਪਰਮਜੀਤ	పరమజీత ; పరమజీత
ਪਰਮਜੁਗਤ	పరమజుగత
ਪਰਮਜੋਗ	పరమజోగ
ਪਰਮਜੋਧ	పరమజోధ
ਪਰਮਠਾਕਰ	పరమఠాకర
ਪਰਮਤੇਕ	పరమతేక
ਪਰਮਦੀਪ	పరమదీప
ਪਰਮਧਾਰਾਮ	పరమధారామ
ਪਰਮਧਿਰ	పరమధిర
ਪਰਮਪਾਲ	పరమపాల
ਪਰਮਪ੍ਰੇਮ	పరమప్రేమ
ਪਰਮਬੋਧ	పరమబోధ
ਪਰਮਯੋਗ	పరమయోగ
ਪਰਮਰਂਗ	పరమరంగ
ਪਰਮਲੀਨ	పరమలీన
ਪਰਮਸ਼ਾਂਤ	పరమసాంత
ਪਰਮਸਿਤਾਲ	పరమసితాల
ਪਰਮਸੁਖ	పరమసుఖ
ਪਰਮਸੇਵਕ	పరమసేవక
ਪਰਮਾਧਾਰ	పరమాధార
ਪਰਮਾਰ੍ਥ	పరమార్థ
ਪਰਮਿਂਦਰ	పరమిందర
ਪਰਮੀਤ	పరమీత
ਪਰਮ੍ਦਯਾ	పరమ్దయా
ਪਰਸਂਜੀਤ	పరసంజీత
ਪਰਸ਼ੋਤਮ	పరసోతమ
ਪਰਾਮਨੀਵਾਸ	పరామనీవాస
ਪਰੀਦਰ੍ਸ਼ਨ	పరీదర్సన
ਪਰ੍ਗਤ	పర్గత
ਪਰ੍ਵੀਨ੍ਦੇਰ	పర్వీన్దేర
ਪਲਬੀਨਦੇਰ	పలబీనదేర
ਪਲਵੀਨ੍ਦੇਰ੍ਪਾਲ	పలవీన్దేర్పాల
ਪਵਾਨਜੋਤ	పవానజోత
ਪਵਾਨਦੀਪ	పవానదీప
ਪਵਾਨਪ੍ਰਿਤ	పవానప్రిత
ਪਵਾਨਵੀਰ	పవానవీర
ਪਵੀਤ	పవీత
ਪਾਰਂਗਤ	పారంగత
ਪੁਨੀਤ	పునీత
ਪੁਨੀਤਪਾਲ	పునీతపాల
ਪੁਰਾਨਪ੍ਰੇਮ	పురానప్రేమ
ਪੁਰਾਨ੍ਜੀਤ	పురాన్జీత
ਪੁਸ਼ਪ੍ਰਿਤ	పుసప్రిత
ਪੁਸ਼੍ਪਿਤਾ	పుస్పితా
ਪੂਰਨਜੀਤ	పూరనజీత
ਪ੍ਰਗਿਤ	ప్రగిత
ਪ੍ਰਜਨਾ	ప్రజనా
ਪ੍ਰਣਿਤ	ప్రణిత
ਪ੍ਰਨੀਤਾ	ప్రనీతా
ਪ੍ਰਫੂਲਦੀਪ	ప్రఫూలదీప
ਪ੍ਰਭਕੀਰਤ	ప్రభకీరత
ਪ੍ਰਭਕੀਰ੍ਪਾਲ	ప్రభకీర్పాల
ਪ੍ਰਭਗੀਤ	ప్రభగీత
ਪ੍ਰਭਚਰਣ	ప్రభచరణ
ਪ੍ਰਭਚੇਤਨ	ప్రభచేతన
ਪ੍ਰਭਜਿਤ	ప్రభజిత
ਪ੍ਰਭਜੀਤ	ప్రభజీత
ਪ੍ਰਭਜੀਵਨ	ప్రభజీవన
ਪ੍ਰਭਜੋਗ	ప్రభజోగ
ਪ੍ਰਭਜੋਤੇ	ప్రభజోతే
ਪ੍ਰਭਜੋਧ	ప్రభజోధ
ਪ੍ਰਭਤਿਰਥ	ప్రభతిరథ
ਪ੍ਰਭਦਾਸ	ప్రభదాస
ਪ੍ਰਭਧਿਯਨ	ప్రభధియన
ਪ੍ਰਭਧਿਰਾਜ	ప్రభధిరాజ
ਪ੍ਰਭਨਾਮ	ప్రభనామ
ਪ੍ਰਭਨੂਰ	ప్రభనూర
ਪ੍ਰਭਪਰ੍ਵਾਨ	ప్రభపర్వాన
ਪ੍ਰਭਬੋਧ	ప్రభబోధ
ਪ੍ਰਭਮਿਤ	ప్రభమిత
ਪ੍ਰਭਮੇਹਾਰ	ప్రభమేహార
ਪ੍ਰਭਲੀਨ	ప్రభలీన
ਪ੍ਰਭਵਿਚਾਰ	ప్రభవిచార
ਪ੍ਰਭਸਂਗਤ	ప్రభసంగత
ਪ੍ਰਭਸਿਤਾਲ	ప్రభసితాల
ਪ੍ਰਭਾਤਕੀਰਣ	ప్రభాతకీరణ
ਪ੍ਰਭ੍ਰਮਣ	ప్రభ్రమణ
ਪ੍ਰਭ੍ਰਾਤਨ	ప్రభ్రాతన
ਪ੍ਰਭ੍ਰੂਪ	ప్రభ్రూప
ਪ੍ਰਸ਼ਾਰਨਬੀਰ	ప్రసారనబీర
ਪ੍ਰਿਤਮੋਹਨ	ప్రితమోహన
ਪ੍ਰਿਤੀਨ੍ਦੇਰ	ప్రితీన్దేర
ਪ੍ਰਿਤ੍ਵੀਰ	ప్రిత్వీర
ਪ੍ਰੀਤਪਾਲ	ప్రీతపాల
ਪ੍ਰੀਤਮ੍ਹਾਰੀ	ప్రీతమ్హారీ
ਪ੍ਰੀਤਾਮਜਿਤ	ప్రీతామజిత
ਪ੍ਰੀਥਾਮ੍ਦੀਪ	ప్రీథామ్దీప
ਪ੍ਰੀਥੀਪਾਲ	ప్రీథీపాల
ਪ੍ਰੀਥ੍ਵੀਪਾਲ	ప్రీథ్వీపాల
ਪ੍ਰੇਮਜਿਤ	ప్రేమజిత
ਪ੍ਰੇਮਤੇਕ	ప్రేమతేక
ਪ੍ਰੇਮਪਾਲ	ప్రేమపాల
ਪ੍ਰੇਮਬਂਸ	ప్రేమబంస
ਪ੍ਰੇਮਭਾਗਤ	ప్రేమభాగత
ਪ੍ਰੇਮਰਂਗ	ప్రేమరంగ
ਪ੍ਰੇਮਰਮਣ	ప్రేమరమణ
ਪ੍ਰੇਮਰਸ	ప్రేమరస
ਪ੍ਰੇਮਲੀਨ	ప్రేమలీన
ਪ੍ਰੇਮਵਾਂਤ	ప్రేమవాంత
ਪ੍ਰੇਮਸੀਰੀ	ప్రేమసీరీ
ਪ੍ਰੇਮਸੁਖ	ప్రేమసుఖ
ਪ੍ਰੇਮ੍ਵੀਰ	ప్రేమ్వీర
ਫਕੀਰ	ఫకీర
ਫਤੇਹਕਾਰਾਮ	ఫతేహకారామ
ਫਤੇਹਪ੍ਰਿਤ	ఫతేహప్రిత
ਫਤੇਹਬੀਰ	ఫతేహబీర
ਫਤੇਹ੍ਵਂਤ	ఫతేహ్వంత
ਫਾਜਲ	ఫాజల
ਫੁਲਵਂਤ	ఫులవంత
ਫੋਜੀਨਦੇਰ	ఫోజీనదేర
ਬਂਸਮਿਤ	బంసమిత
ਬਕ੍ਸ਼ੀ	బక్సీ
ਬਚਾਨਬੀਰ	బచానబీర
ਬਚੀਨ੍ਤ	బచీన్త
ਬਨੀਤ	బనీత
ਬਨੀਨਦੇਰ	బనీనదేర
ਬਰਿਨ੍ਦ੍ਰ	బరిన్ద్ర
ਬਰੀਨ੍ਦੇਰ	బరీన్దేర
ਬਲਤੇਜ	బలతేజ
ਬਲਦੀਪ	బలదీప
ਬਲਦੇਵ	బలదేవ
ਬਲਮੋਹਨ	బలమోహన
ਬਲਰਾਜ	బలరాజ
ਬਲਵਿਂਦਰ	బలవిందర
ਬਲੀਨਦੇਰ	బలీనదేర
ਬਲੀਹਾਰ	బలీహార
ਬਲ੍ਵਿਨ੍ਦ੍ਰ	బల్విన్ద్ర
ਬਲ੍ਵੀਨ੍ਦੇਰ	బల్వీన్దేర
ਬਹਾਦਰ	బహాదర
ਬਾਲਮਿਤ	బాలమిత
ਬਿਸ਼ਨਪਾਲ	బిసనపాల
ਬਿਸ੍ਮੀਤ	బిస్మీత
ਬੀਨਦੇਰ	బీనదేర
ਬੀਨਾ	బీనా
ਬੀਬੀਨਾਨਾਕੀ	బీబీనానాకీ
ਬੀਮਾਂਲਜੋਤ	బీమాంలజోత
ਬੀਰੀਨਦਾਰ	బీరీనదార
ਬੀਸਮਾਧ	బీసమాధ
ਬੀਸ਼੍ਮਿਤ	బీస్మిత
ਬੁਜੀ	బుజీ
ਬੁਧ੍ਪ੍ਰਿਤ	బుధ్ప్రిత
ਬੁਧ੍ਰੂਪ	బుధ్రూప
ਬੇਂਤ	బేంత
ਬੇਨ੍ਨੀ	బేన్నీ
ਬੇਬੇ	బేబే
ਬੈਰਾਗੀ	బైరాగీ
ਬ੍ਰਹਮਜੋਤ	బ్రహమజోత
ਬ੍ਰਹਾਮਲੀਨ	బ్రహామలీన
ਬ੍ਰਹਾਮ੍ਜੀਤ	బ్రహామ్జీత
ਬ੍ਰਹ੍ਮਲੀਨ	బ్రహ్మలీన
ਬ੍ਰਹ੍ਮਵੀਰ	బ్రహ్మవీర
ਬ੍ਰਿਜੇਂਦਰ	బ్రిజేందర
ਬ੍ਰੀਜੋਧ	బ్రీజోధ
ਭਗਤ	భగత
ਭਗਵਾਨ	భగవాన
ਭਜਨਿਕ	భజనిక
ਭਰਪੂਰ	భరపూర
ਭਾਘਵੀਨ੍ਦੇਰ	భాఘవీన్దేర
ਭਾਜ੍ਨਾਮ	భాజ్నామ
ਭਾਜ੍ਨਿਤ	భాజ్నిత
ਭਾਵਜਿਤ	భావజిత
ਭਾਵਜੀਨ੍ਦੇਰ	భావజీన్దేర
ਭਾਵਨਦੀਪ	భావనదీప
ਭਾਵਨੀਤ	భావనీత
ਭਾਵਪਾਲ	భావపాల
ਭਾਵਪ੍ਰੇਮ	భావప్రేమ
ਭਾਵਲੀਨ	భావలీన
ਭੀਨਦੇਰ੍ਪਾਲ	భీనదేర్పాల
ਭੁਪੀਨ੍ਦੇਰ	భుపీన్దేర
ਮਂਗਲਾ	మంగలా
ਮਂਤੇਕ	మంతేక
ਮਜਾਲ	మజాల
ਮਣਿਪਾਲ	మణిపాల
ਮਧੁਪ੍ਰਿਤ	మధుప్రిత
ਮਧੁਰਬੀਨ	మధురబీన
ਮਧੁਵਂਤ	మధువంత
ਮਨਵਂਤ	మనవంత
ਮਰਦੁਲਾ	మరదులా
ਮਸ੍ਤਪ੍ਰੇਮ	మస్తప్రేమ
ਮਸ੍ਤਾਨ	మస్తాన
ਮਸ੍ਤੁਕ	మస్తుక
ਮਸ੍ਤ੍ਵੀਰ	మస్త్వీర
ਮਹਨਬੀਰ	మహనబీర
ਮਹਾਜਿਤ	మహాజిత
ਮਹਾਨਗਿਯਨ	మహానగియన
ਮਹਾਨਗੀਤ	మహానగీత
ਮਹਾਨਗੁਨ	మహానగున
ਮਹਾਨਜਿਤ	మహానజిత
ਮਹਾਨਜੀਵਨ	మహానజీవన
ਮਹਾਨਜੋਤ	మహానజోత
ਮਹਾਨਤੇਕ	మహానతేక
ਮਹਾਨਤ੍ਰੀਪਾਤ	మహానత్రీపాత
ਮਹਾਨਦੀਪ	మహానదీప
ਮਹਾਨਪਾਲ	మహానపాల
ਮਹਾਨਪ੍ਰੇਮ	మహానప్రేమ
ਮਹਾਨਭਗਤ	మహానభగత
ਮਹਿਨਦੇਰ੍ਪ੍ਰਿਤ	మహినదేర్ప్రిత
ਮਹੀਨਗਾ	మహీనగా
ਮਹੀਨਦੇਰ੍ਪਾਲ	మహీనదేర్పాల
ਮਹੇਕਪ੍ਰਿਤ	మహేకప్రిత
ਮਹੇਨਦੇਰ	మహేనదేర
ਮਹੇਰਬਾਨੀ	మహేరబానీ
ਮਹੇਸ਼ੀਨਦੇਰ	మహేసీనదేర
ਮਾਂਨਕਰਣ	మాంనకరణ
ਮਾਂਨਗਲ੍ਪ੍ਰਿਤ	మాంనగల్ప్రిత
ਮਾਂਨਵਾਨ੍ਤ੍ਬੀਰ	మాంనవాన్త్బీర
ਮਾਂਨਸੀਰਤ	మాంనసీరత
ਮਾਂਨਾਵੀਨਦੇਰ	మాంనావీనదేర
ਮਾਂਨਾਸਪ੍ਰੇਮ	మాంనాసప్రేమ
ਮਾਂਨੀਨਦੇਰ੍ਬੀਰ	మాంనీనదేర్బీర
ਮਾਂਨੋਹਾਰਜੋਤ	మాంనోహారజోత
ਮਾਂਨੋਹਾਰਦੀਪ	మాంనోహారదీప
ਮਾਂਨੋਹਾਰ੍ਜੀਤ	మాంనోహార్జీత
ਮਾਂਨੋਹਾਰ੍ਪਲ	మాంనోహార్పల
ਮਾਂਨ੍ਗਲ੍ਜੀਤ	మాంన్గల్జీత
ਮਾਂਨ੍ਗਲ੍ਪ੍ਰੇਮ	మాంన్గల్ప్రేమ
ਮਾਂਨ੍ਸ਼ਿਤਾਲ	మాంన్సితాల
ਮਾਦਨਬੀਰ	మాదనబీర
ਮਾਦਾਨਕੀਰ੍ਪਾਲ	మాదానకీర్పాల
ਮਾਦਾਨਪਾਲ	మాదానపాల
ਮਾਨਤੇਜ	మానతేజ
ਮਾਨਦੇਵ	మానదేవ
ਮਾਨਪੁਲ	మానపుల
ਮਾਨਬੀਰ	మానబీర
ਮਾਨਰਿਤ	మానరిత
ਮਾਨਾਸਦੀਪ	మానాసదీప
ਮਾਨ੍ਕੀਰਣ	మాన్కీరణ
ਮਾਨ੍ਗਲ੍ਜੋਤ	మాన్గల్జోత
ਮਾਨ੍ਪ੍ਰੀਯਾ	మాన్ప్రీయా
ਮਾਯ੍ਰਾਯ	మాయ్రాయ
ਮਿਤ੍ਰਾ	మిత్రా
ਮਿਤ੍ਰਾਜ	మిత్రాజ
ਮੀਰਾ	మీరా
ਮੁਕੁਂਦਾ	ముకుందా
ਮੁਕੁਨਦ੍ਪ੍ਰਿਤ	ముకునద్ప్రిత
ਮੁਖ੍ਤਯਾਰ	ముఖ్తయార
ਮੁਦ੍ਰਾ	ముద్రా
ਮੁਨਦੀਪ	మునదీప
ਮੁਨਲੇਨੇ	మునలేనే
ਮੇਸ਼	మేస
ਮੇਹਰ	మేహర
ਮੇਹਾਰਤੇਕ	మేహారతేక
ਮੇਹਾਰਪਲ	మేహారపల
ਮੇਹਾਰਪ੍ਰਿਤ	మేహారప్రిత
ਮੇਹਾਰਭੂਪ	మేహారభూప
ਮੇਹਾਰਮਿਤ	మేహారమిత
ਮੇਹੇਰ	మేహేర
ਮੇਹੇਰਬਾਨੀ	మేహేరబానీ
ਮੋਨੀਨ੍ਦੇਰ	మోనీన్దేర
ਮੋਹਨਤੇਕ	మోహనతేక
ਮੋਹਨਮਿਤ	మోహనమిత
ਮੋਹਨਲੀਨ	మోహనలీన
ਮੋਹਨਵਂਤ	మోహనవంత
ਮੋਹਨਵੀਰ	మోహనవీర
ਮੋਹਿਨ੍ਦੇਰਪਾਲ	మోహిన్దేరపాల
ਮੋਹੇਨਪਲ	మోహేనపల
ਮੋਹੇਨਪ੍ਰਿਤ	మోహేనప్రిత
ਯਕਿਨ	యకిన
ਯਸ਼ਜੋਤ	యసజోత
ਯਸ਼ਨੂਰ	యసనూర
ਯਸ਼ਪਾਲ	యసపాల
ਯਸ਼ਵਂਤ	యసవంత
ਯਸ਼੍ਦੀਪ	యస్దీప
ਯਾਤੀਨਪਾਲ	యాతీనపాల
ਯਾਦਲੀਨ	యాదలీన
ਯਾਦਵੀਰ	యాదవీర
ਯਾਦ੍ਬੀਰ	యాద్బీర
ਯਾਸ੍ਮੀਨੇ	యాస్మీనే
ਯੁਵਰਾਨੀ	యువరానీ
ਯੋਗੇਸ਼ਪਾਲ	యోగేసపాల
ਰਂਗ ਰਮਨ	రంగ రమన
ਰਂਗਜੋਤ	రంగజోత
ਰਂਗਪ੍ਰਿਤ	రంగప్రిత
ਰਂਗਾਤਮ	రంగాతమ
ਰਂਗੀਵਨ	రంగీవన
ਰਂਜੀਤ	రంజీత
ਰਘੁਜਿਤ	రఘుజిత
ਰਘੁਬਂਸ	రఘుబంస
ਰਚਨਜਿਤ	రచనజిత
ਰਚਨਜੋਤ	రచనజోత
ਰਚ੍ਪੀਨਦੇਰ੍ਜਿਤ	రచ్పీనదేర్జిత
ਰਜੀਨਦਾਰ	రజీనదార
ਰਣਦੀਪ	రణదీప
ਰਣਬੀਰ	రణబీర
ਰਤਨ੍ਕਾਰਾਮ	రతన్కారామ
ਰਤ੍ਤਾਨਜੋਤ	రత్తానజోత
ਰਤ੍ਤਾਨਦੀਪ	రత్తానదీప
ਰਨਗ੍ਰਤ੍ਤੀ	రనగ్రత్తీ
ਰਨਪ੍ਰਿਤ	రనప్రిత
ਰਪੀਨਦੇਰ	రపీనదేర
ਰਮਚੇਤਨ	రమచేతన
ਰਮਣੀਕ	రమణీక
ਰਮਨਜਿਤ	రమనజిత
ਰਮਨਦੀਪ	రమనదీప
ਰਮਨਿਤ	రమనిత
ਰਮਨੀਵਾਸ	రమనీవాస
ਰਮਲੀਨ	రమలీన
ਰਮਾਂਨਜੋਤ	రమాంనజోత
ਰਮਾਂਨਰੂਪ	రమాంనరూప
ਰਮਾਂਨਸੁਖ	రమాంనసుఖ
ਰਮਿਤ	రమిత
ਰਮਿਨਾਜੀਤ	రమినాజీత
ਰਮੀਨਦੇਰ੍ਜਿਤ	రమీనదేర్జిత
ਰਮੀਨਦੇਰ੍ਪਾਲ	రమీనదేర్పాల
ਰਮੀਨਦੇਰ੍ਪ੍ਰਿਤ	రమీనదేర్ప్రిత
ਰਮੀਨਦੇਰ੍ਬੀਰ	రమీనదేర్బీర
ਰਮੇਸ਼ਪਲ	రమేసపల
ਰਮੇਸ਼ਮਿਤ	రమేసమిత
ਰਵਜੋਤ	రవజోత
ਰਵਨੀਤ	రవనీత
ਰਵਿਨ੍ਦਰ	రవిన్దర
ਰਵਿਰਾਜ	రవిరాజ
ਰਵੀਦੀਪ	రవీదీప
ਰਵੀਨਦੇਰ੍ਦੀਪ	రవీనదేర్దీప
ਰਵੀਨਦੇਰ੍ਮਿਤ	రవీనదేర్మిత
ਰਸਂਜਿਤ	రసంజిత
ਰਸਂਜੋਤ	రసంజోత
ਰਸਂਮਿਤ	రసంమిత
ਰਸਗੁਨ	రసగున
ਰਸਜੋਤ	రసజోత
ਰਸਧਾਰਮ	రసధారమ
ਰਸਨਂਦ	రసనంద
ਰਸਪ੍ਰਿਤ	రసప్రిత
ਰਸਬੀਰ	రసబీర
ਰਸਭਾਗਤ	రసభాగత
ਰਸਮ	రసమ
ਰਸਮ੍ਰਿਤ	రసమ్రిత
ਰਸਲੀਨ	రసలీన
ਰਸਵਂਤ	రసవంత
ਰਸ਼ਾਨ੍ਪ੍ਰਿਤ	రసాన్ప్రిత
ਰਸੁਤ੍ਤਮ	రసుత్తమ
ਰਹੁਲਜੀਤ	రహులజీత
ਰਹੁਲਦੀਪ	రహులదీప
ਰਾਖਨਾਂ	రాఖనాం
ਰਾਖਬੀਰ	రాఖబీర
ਰਾਜਕਿਰਣ	రాజకిరణ
ਰਾਜਦੀਪ	రాజదీప
ਰਾਜਨਾਰੀਨ੍ਦ	రాజనారీన్ద
ਰਾਜਪਰਾਮ	రాజపరామ
ਰਾਜਪਾਲ	రాజపాల
ਰਾਜਪ੍ਰਤਾਪ	రాజప్రతాప
ਰਾਜਮਂਦਰ	రాజమందర
ਰਾਜਮਿਤ	రాజమిత
ਰਾਜਸ਼ਰਣ	రాజసరణ
ਰਾਜਸੁਖ	రాజసుఖ
ਰਾਜਾਨਜਿਤ	రాజానజిత
ਰਾਜਾਨਮਿਤ	రాజానమిత
ਰਾਜਾਨ੍ਦੀਪ	రాజాన్దీప
ਰਾਤਾਨਗੀਤ	రాతానగీత
ਰਾਤਾਨਚੇਤਨ	రాతానచేతన
ਰਾਤਾਨਜੀਵਨ	రాతానజీవన
ਰਾਤਾਨਪ੍ਰਿਤ	రాతానప్రిత
ਰਾਤਾਨਮਿਤ	రాతానమిత
ਰਾਤਾਨਵਂਤ	రాతానవంత
ਰਾਤਾਨਾਤਮ	రాతానాతమ
ਰਾਮਦਾਸ	రామదాస
ਰਾਮਪਾਲ	రామపాల
ਰਾਮਰਂਗ	రామరంగ
ਰਾਮਰਤ੍ਤਨ	రామరత్తన
ਰਾਮਸੁਖ	రామసుఖ
ਰਾਸਰਮਣ	రాసరమణ
ਰਾਸ਼੍ਪਲ	రాస్పల
ਰਾਸ਼੍ਮੀਨਦੇਰ	రాస్మీనదేర
ਰਿਧਿਮਾ	రిధిమా
ਰੀਜਕ	రీజక
ਰੀਤੀਨਦੇਰ	రీతీనదేర
ਰੀਪਨ੍ਜੋਤ	రీపన్జోత
ਰੀਪੁਦਮ	రీపుదమ
ਰੂਂਗ / ਰਂਗ	రూంగ / రంగ
ਰੂਪਦੀਪ	రూపదీప
ਰੂਪਦੇਵ	రూపదేవ
ਰੂਪਵਂਤ	రూపవంత
ਰੇਗੇਨਦਰ	రేగేనదర
ਰੋਸ਼ਨਦੀਪ	రోసనదీప
ਰੌਸ਼ਾਨਪ੍ਰੇਮ	రౌసానప్రేమ
ਰੌਸ਼ਾਨਬੀਰ	రౌసానబీర
ਲਕ੍ਸ਼੍ਮੀ	లక్స్మీ
ਲਖਪ੍ਰਿਤ	లఖప్రిత
ਲਖਮਿਤ	లఖమిత
ਲਖਰੂਪ	లఖరూప
ਲਖਵੀਰ	లఖవీర
ਲਵੇਨਿਤ	లవేనిత
ਲਾਜਵਂਤ	లాజవంత
ਲਾਵਪ੍ਰਿਤ	లావప్రిత
ਲਾਵਿਨਦੀਪ	లావినదీప
ਲੀਵਗੀਆਨ	లీవగీఆన
ਲੀਵਚਿਤ	లీవచిత
ਲੀਵਚੇਤ	లీవచేత
ਲੀਵਜੋਤ	లీవజోత
ਲੀਵਨਾਮ	లీవనామ
ਲੀਵਸ਼ਰਣ	లీవసరణ
ਲੀਵਾਵਤਰ	లీవావతర
ਲੋਕਪਾਲ	లోకపాల
ਲੋਕਪ੍ਰਿਤ	లోకప్రిత
ਲੋਕਰੂਪ	లోకరూప
ਲੋਕ੍ਪ੍ਰੇਮ	లోక్ప్రేమ
ਲੋਵਪ੍ਰੇਮ	లోవప్రేమ
ਲੋਵੇਦੀਪ	లోవేదీప
ਵਰੀਨਦੇਰ੍ਪਾਲ	వరీనదేర్పాల
ਵਰੁਨਜਿਤ	వరునజిత
ਵਰੁਨਦੀਪ	వరునదీప
ਵਸਂਤਪ੍ਰਿਤ	వసంతప్రిత
ਵਸੁਂਧਰਾ	వసుంధరా
ਵਾਦਭਾਗ	వాదభాగ
ਵਾਮਾਂਨਜੀਤ	వామాంనజీత
ਵਾਰੀਨਦੇਰ	వారీనదేర
ਵਾਸੀਮਬੀਰ	వాసీమబీర
ਵਾਹੀਦਪ੍ਰਿਤ	వాహీదప్రిత
ਵਾਹੇਗੁਰੁ	వాహేగురు
ਵਿਕ੍ਰਮਜੀਤ	విక్రమజీత
ਵਿਕ੍ਰਮਜੋਤ	విక్రమజోత
ਵਿਚਾਰ੍ਚੇਤਨ	విచార్చేతన
ਵਿਚਾਰ੍ਦੀਪ	విచార్దీప
ਵਿਚਾਰ੍ਲੀਨ	విచార్లీన
ਵਿਜਯਪ੍ਰਤਾਪ	విజయప్రతాప
ਵਿਜਯਪ੍ਰਿਤ	విజయప్రిత
ਵਿਜੇਂਦਰ	విజేందర
ਵਿਨਾਯਦੀਪ	వినాయదీప
ਵਿਨਾਯਪੁਲ	వినాయపుల
ਵਿਨਾਯ੍ਬਿਰ	వినాయ్బిర
ਵਿਮਾਂਲਜਿਤ	విమాంలజిత
ਵਿਮਾਂਲਜੋਤ	విమాంలజోత
ਵਿਮਾਂਲਪ੍ਰੇਮ	విమాంలప్రేమ
ਵਿਰੀਨਦਾਰ ; ਵਿਰੀਨਦੇਰ	విరీనదార ; విరీనదేర
ਵਿਰੀਨਦੇਰ	విరీనదేర
ਵਿਸਮਦ	విసమద
ਵਿਸ਼ਾਲਦੀਪ	విసాలదీప
ਵਿਸ਼ਾਲਪ੍ਰਿਤ	విసాలప్రిత
ਵਿਸ਼੍ਵਰ੍ਪ੍ਰਿਤ	విస్వర్ప్రిత
ਵਿਸ਼੍ਵਾਤਮ	విస్వాతమ
ਵਿਸਾਹ	విసాహ
ਵੀਜਯਮਿਤ	వీజయమిత
ਵੀਰ	వీర
ਵੀਰ /ਵੀਰ	వీర /వీర
ਵੀਰਪਾਲ	వీరపాల
ਵੀਵੇਕ੍ਬੀਰ	వీవేక్బీర
ਵੀਸ੍ਰਮਣ	వీస్రమణ
ਵੇਰਾਜ	వేరాజ
ਵੈਭਵ	వైభవ
ਸਂਗਜਾਪ	సంగజాప
ਸਂਗਤਪ੍ਰਿਤ	సంగతప్రిత
ਸਂਗਤਰੂਪ	సంగతరూప
ਸਂਗਤ੍ਰਸ	సంగత్రస
ਸਂਗੀਤਾ	సంగీతా
ਸਂਗ੍ਰਾਮ	సంగ్రామ
ਸਂਜੀਤ	సంజీత
ਸਂਜੋਗ	సంజోగ
ਸਂਤਕੀਰੀਨ	సంతకీరీన
ਸਂਤਪ੍ਰਕਾਸ਼	సంతప్రకాస
ਸਂਤਪ੍ਰੇਮ	సంతప్రేమ
ਸਂਤਬੀਰ	సంతబీర
ਸਂਤੋਖਜੀਤ	సంతోఖజీత
ਸਂਤੋਖਜੋਤ	సంతోఖజోత
ਸਂਤੋਖਪ੍ਰਿਤ	సంతోఖప్రిత
ਸਂਤੋਖਬੀਰ	సంతోఖబీర
ਸਂਦੀਪ	సందీప
ਸਗਲਜੋਤ	సగలజోత
ਸਚਕਿਰਤ	సచకిరత
ਸਚਜੋਗ	సచజోగ
ਸਚਪਾਲ	సచపాల
ਸਚਪ੍ਰਧਾਨ	సచప్రధాన
ਸਚਭਾਗਤ	సచభాగత
ਸਚਮਾਨ	సచమాన
ਸਚਰੂਪ	సచరూప
ਸਚਵੀਰ	సచవీర
ਸਚਸੁਖ	సచసుఖ
ਸਚਸੇਵਕ	సచసేవక
ਸਚਾਮ੍ਰਿਤ	సచామ్రిత
ਸਚ੍ਦੀਪ	సచ్దీప
ਸਜੀਨਦੇਰ	సజీనదేర
ਸਤਕਿਰਤ	సతకిరత
ਸਤਕੀਰਤ	సతకీరత
ਸਤਕੀਰ੍ਤਨ	సతకీర్తన
ਸਤਗੁਨ	సతగున
ਸਤਗੁਰ	సతగుర
ਸਤਜੋਤ	సతజోత
ਸਤਨਾਮ	సతనామ
ਸਤਪਾਲ	సతపాల
ਸਤਪ੍ਰਕਾਸ਼	సతప్రకాస
ਸਤਪ੍ਰਿਤ	సతప్రిత
ਸਤਪ੍ਰੇਮ	సతప్రేమ
ਸਤਬਚਨ	సతబచన
ਸਤਮਿਤ	సతమిత
ਸਤਰਜਿਤ	సతరజిత
ਸਤਰਾਜ	సతరాజ
ਸਤਲੀਨ	సతలీన
ਸਤਵਂਤ	సతవంత
ਸਤਸਂਗਤ	సతసంగత
ਸਤਸਂਤੋਖ	సతసంతోఖ
ਸਤਸਰਂਗ	సతసరంగ
ਸਤਸੁਖ	సతసుఖ
ਸਤੀਨਦੇਰ੍ਜਿਤ	సతీనదేర్జిత
ਸਤ੍ਯਜਿਤ	సత్యజిత
ਸਤ੍ਯਪ੍ਰੇਮ	సత్యప్రేమ
ਸਥਿਨ੍ਦਰ	సథిన్దర
ਸਦਜੀਵਨ	సదజీవన
ਸਦਸੁਖ	సదసుఖ
ਸਨਮੁਖ	సనముఖ
ਸਨਾਨਤਨ	సనానతన
ਸਪਨਦੀਪ	సపనదీప
ਸਪਾਹੀ	సపాహీ
ਸਬੂਰੀ	సబూరీ
ਸਭਾਜੀਤ	సభాజీత
ਸਮਰਜੀਤ	సమరజీత
ਸਮਰਣ	సమరణ
ਸਮਰਵੀਰ	సమరవీర
ਸਮਰ੍ਥ	సమర్థ
ਸਮਾਂਰਬੀਰ	సమాంరబీర
ਸਮਾਂਰ੍ਜੋਤ	సమాంర్జోత
ਸਮਾਈ	సమాఈ
ਸਮੀਨਦੀਪ	సమీనదీప
ਸਮੀਰ	సమీర
ਸਰਦਾਰ	సరదార
ਸਰਨਦਾਯਲ	సరనదాయల
ਸਰਨਦੀਪ	సరనదీప
ਸਰਨਾਗਤ	సరనాగత
ਸਰਬਜੀਤ / ਸਰਬਜੀਤ	సరబజీత / సరబజీత
ਸਰਬਨੀਵਾਸ	సరబనీవాస
ਸਰਬਪ੍ਰਿਤ	సరబప్రిత
ਸਰਬਸੁਖ	సరబసుఖ
ਸਰਬੁਤ੍ਤਮ	సరబుత్తమ
ਸਰਬ੍ਗਿਆਨ	సరబ్గిఆన
ਸਰਬ੍ਜਿਤ	సరబ్జిత
ਸਰਬ੍ਦਾਯਲ	సరబ్దాయల
ਸਰਬ੍ਦੀਪ	సరబ్దీప
ਸਰਬ੍ਦੇਵ	సరబ్దేవ
ਸਰਬ੍ਧਾਰਾਮ	సరబ్ధారామ
ਸਰਲਜਿਤ	సరలజిత
ਸਰਲਬੀਰ	సరలబీర
ਸਰਾਬ੍ਰਜ	సరాబ్రజ
ਸਰੂਪ	సరూప
ਸਰੂਰ	సరూర
ਸਰ੍ਜਿਤ	సర్జిత
ਸਰ੍ਮੀਨਦੇਰ	సర్మీనదేర
ਸਵਾਨਪ੍ਰਿਤ	సవానప్రిత
ਸਵਾਰਜਦੀਪ	సవారజదీప
ਸਵਾਰਜਬੀਰ	సవారజబీర
ਸਵਾਰਨਜੋਤ	సవారనజోత
ਸਵਾਰਨਪ੍ਰਿਤ	సవారనప్రిత
ਸਵੀਤੀਨਦੇਰ	సవీతీనదేర
ਸਵੀਤੋਜ	సవీతోజ
ਸਵੀਨਦੇਰ	సవీనదేర
ਸਹੀਲਮਿਤ	సహీలమిత
ਸ਼ਯ੍ਮ੍ਸੁਨ੍ਦਾਰ	సయ్మ్సున్దార
ਸ਼ਰਨਪਾਲ	సరనపాల
ਸ਼ਰਨਬੀਰ	సరనబీర
ਸ਼ਰਨ੍ਜੀਤ੍ਕੌਰ	సరన్జీత్కౌర
ਸ਼ਾਂਤਚਿਤ	సాంతచిత
ਸ਼ਾਂਤਦੀਪ	సాంతదీప
ਸ਼ਾਂਤਪ੍ਰਕਾਸ਼	సాంతప్రకాస
ਸ਼ਾਂਤਪ੍ਰਿਤ	సాంతప్రిత
ਸ਼ਾਂਤਬੀਰ	సాంతబీర
ਸ਼ਾਂਤਲੀਨ	సాంతలీన
ਸ਼ਾਨਤ੍ਨੀਵਾਸ	సానత్నీవాస
ਸ਼ਾਬਦਚੇਤ	సాబదచేత
ਸ਼ਾਬਦਤੇਕ	సాబదతేక
ਸ਼ਾਬਦ੍ਰਾਸ	సాబద్రాస
ਸ਼ਾਬਾਦ੍ਦੀਪ	సాబాద్దీప
ਸ਼ਾਲੀਨ	సాలీన
ਸ਼ਾਸ਼ੀਪ੍ਰਿਤ	సాసీప్రిత
ਸ਼ਿਵਚਰਣ	సివచరణ
ਸ਼ਿਵ੍ਚਾਰਨ੍ਜੀਤ	సివ్చారన్జీత
ਸ਼ੁਕਾਰਿਯਨ	సుకారియన
ਸ਼ੁਭਦੀਪ	సుభదీప
ਸ਼ੂਰਵੀਰ	సూరవీర
ਸ਼ੇਰ	సేర
ਸ਼ੇਰਪੁਲ	సేరపుల
ਸ਼ੇਰਬਹਾਦੁਰ	సేరబహాదుర
ਸ਼ੇਹ੍ਬਾਝ	సేహ్బాఝ
ਸਾਕਰਥ	సాకరథ
ਸਾਖ	సాఖ
ਸਾਗਰ	సాగర
ਸਾਜ	సాజ
ਸਾਤਪੁਲ	సాతపుల
ਸਾਧਨਾਹ	సాధనాహ
ਸਾਧਿਕਾ	సాధికా
ਸਾਬਰ	సాబర
ਸਾਰ	సార
ਸਿਂਦਾ	సిందా
ਸਿਓਪਰਿਤ	సిఓపరిత
ਸਿਤਾਲਜੀਤ	సితాలజీత
ਸਿਤਾਲਜੋਤ	సితాలజోత
ਸਿਮਰਨ	సిమరన
ਸੀਖਲ	సీఖల
ਸੀਮਾਂਰ੍ਜਿਤ	సీమాంర్జిత
ਸੀਮਾਂਰ੍ਨਾਮ	సీమాంర్నామ
ਸੀਮਾਂਰ੍ਪ੍ਰਿਤ	సీమాంర్ప్రిత
ਸੀਮਾਂਰ੍ਲੀਨ	సీమాంర్లీన
ਸੀਮ੍ਰਤ	సీమ్రత
ਸੀਮ੍ਰਨਪਾਲ	సీమ్రనపాల
ਸੀਮ੍ਰਨਪ੍ਰਿਤ	సీమ్రనప్రిత
ਸੀਮ੍ਰਨ੍ਕੌਰ	సీమ్రన్కౌర
ਸੀਮ੍ਰਨ੍ਜੀਤ	సీమ్రన్జీత
ਸੀਮ੍ਰੀਤਾ	సీమ్రీతా
ਸੀਰਤ	సీరత
ਸੀਰੀਪ੍ਰੀਤਮ	సీరీప్రీతమ
ਸੀਰੀਵੇਦ੍ਯਾ	సీరీవేద్యా
ਸੀਰੀਸੀਮ੍ਰਣ	సీరీసీమ్రణ
ਸੀਰੀਸੇਵਾ	సీరీసేవా
ਸੁਖਚੈਨ	సుఖచైన
ਸੁਖਜੀਵਨ	సుఖజీవన
ਸੁਖਜੋਤ	సుఖజోత
ਸੁਖਜੋਧ	సుఖజోధ
ਸੁਖਦਾਯਲ	సుఖదాయల
ਸੁਖਦੀਪ	సుఖదీప
ਸੁਖਦੇਵ	సుఖదేవ
ਸੁਖਬੀਰ	సుఖబీర
ਸੁਖਮਾਂ	సుఖమాం
ਸੁਖਰੂਪ	సుఖరూప
ਸੁਖਸਿਤਾਲ	సుఖసితాల
ਸੁਖਸੀਮ੍ਰਣ	సుఖసీమ్రణ
ਸੁਖਾਨਂਦ	సుఖానంద
ਸੁਖਿਤ	సుఖిత
ਸੁਖੀਨ	సుఖీన
ਸੁਖੀਨ੍ਦੇਰ	సుఖీన్దేర
ਸੁਖ੍ਚਾਰਨ੍ਜੀਤ	సుఖ్చారన్జీత
ਸੁਖ੍ਜਿਤ	సుఖ్జిత
ਸੁਚਦੀਪ	సుచదీప
ਸੁਚਦੇਵ	సుచదేవ
ਸੁਚਮ	సుచమ
ਸੁਜਨਰੂਪ	సుజనరూప
ਸੁਜਨ੍ਬੀਰ	సుజన్బీర
ਸੁਜ੍ਜਨ	సుజ్జన
ਸੁਧਬੁਧ	సుధబుధ
ਸੁਧਸੁਰਤ	సుధసురత
ਸੁਭਪ੍ਰਿਤ	సుభప్రిత
ਸੁਹੇਜਦੀਪ	సుహేజదీప
ਸੇਵਾਕਪ੍ਰਿਤ	సేవాకప్రిత
ਸੇਵਾਕਪ੍ਰੇਮ	సేవాకప్రేమ
ਸੇਵਾਕਰਣ	సేవాకరణ
ਸੇਵਾਪ੍ਰੀਤ	సేవాప్రీత
ਸੇਹਜ	సేహజ
ਸੇਹੇਜਬੀਰ	సేహేజబీర
ਸੈਲੇਸ਼ਦੀਪ	సైలేసదీప
ਸੈਹਜ	సైహజ
ਸੈਹਾਜਨੀਵਾਸ	సైహాజనీవాస
ਸੈਹਾਜਲੀਨ	సైహాజలీన
ਸੈਹਾਜਾਧਾਰ	సైహాజాధార
ਸੋਚੀ	సోచీ
ਸੋਨਹਨ	సోనహన
ਸੋਭਾਵਂਤ	సోభావంత
ਸੋਹੀਨਦੇਰ	సోహీనదేర
ਸੋਹੁਨ	సోహున
ਸ੍ਵਰ੍ਨ	స్వర్న
ਹਕਾਮਪ੍ਰਿਤ	హకామప్రిత
ਹਨ੍ਸ੍ਪਾਲ	హన్స్పాల
ਹਰਕਾਨ੍ਵਾਲ	హరకాన్వాల
ਹਰਕੀਰਣ	హరకీరణ
ਹਰਗੀਤ	హరగీత
ਹਰਗੁਰ੍ਮਿਤ (ਮਿਤ )	హరగుర్మిత (మిత )
ਹਰਗੋਬੀਨ੍ਦ	హరగోబీన్ద
ਹਰਚਰਣ	హరచరణ
ਹਰਜਪ	హరజప
ਹਰਜੀ	హరజీ
ਹਰਜੀਤ	హరజీత
ਹਰਜੀਨ੍ਦੇਰ	హరజీన్దేర
ਹਰਜੀਵ	హరజీవ
ਹਰਜੁਗਤ	హరజుగత
ਹਰਜੋਗ	హరజోగ
ਹਰਜੋਧ	హరజోధ
ਹਰਜ੍ਯੋਤ	హరజ్యోత
ਹਰਤਿਰਥ	హరతిరథ
ਹਰਤੇਜ੍ਪਾਲ	హరతేజ్పాల
ਹਰਦਯਾਲ	హరదయాల
ਹਰਦਾਸ	హరదాస
ਹਰਦਿਪਾ	హరదిపా
ਹਰਦੀਪ	హరదీప
ਹਰਧਨ	హరధన
ਹਰਨਾਮ	హరనామ
ਹਰਨਾਰਾਯਣ	హరనారాయణ
ਹਰਨਿਤ	హరనిత
ਹਰਨੀਰ੍ਮਲ	హరనీర్మల
ਹਰਨੀਹਲ	హరనీహల
ਹਰਪਰ੍ਸਨ੍ਨ	హరపర్సన్న
ਹਰਪਾਲ	హరపాల
ਹਰਪ੍ਰੇਮ੍ਜੀਤ	హరప్రేమ్జీత
ਹਰਬਿਂਦਰ	హరబిందర
ਹਰਬਿਰ	హరబిర
ਹਰਭਗਤ	హరభగత
ਹਰਮਨਾਦ	హరమనాద
ਹਰਮਾਂਨ੍ਦੇਰ	హరమాంన్దేర
ਹਰਮੀਤ	హరమీత
ਹਰਮੀਲਨ	హరమీలన
ਹਰਮੂਰਤ	హరమూరత
ਹਰਰਾਈ	హరరాఈ
ਹਰਰੂਪ	హరరూప
ਹਰਵਂਤ	హరవంత
ਹਰਵਿਨ	హరవిన
ਹਰਸ਼ਰਣ	హరసరణ
ਹਰਸਿਤਾਲ	హరసితాల
ਹਰਸੀਮ੍ਰਣ	హరసీమ్రణ
ਹਰਸੀਮ੍ਰਨ੍ਜੋਤ	హరసీమ్రన్జోత
ਹਰਸੀਮ੍ਰਿਤ	హరసీమ్రిత
ਹਰਸੁਖ	హరసుఖ
ਹਰਾਨੂਪ	హరానూప
ਹਰਾਮ੍ਰੀਤ	హరామ్రీత
ਹਰਿਕੀਰ੍ਤਨ	హరికీర్తన
ਹਰਿਦਰ੍ਸ਼ਨ	హరిదర్సన
ਹਰਿਨਾਰਾਯਣ	హరినారాయణ
ਹਰਿਪ੍ਰੀਤ	హరిప్రీత
ਹਰੀਅਮ੍ਰਿਤ	హరీఅమ్రిత
ਹਰੀਸਰੂਪ	హరీసరూప
ਹਰੀਸੀਮਾਂਰਣ	హరీసీమాంరణ
ਹਰ੍ਕਾਰਾਨ੍ਜੀਤ	హర్కారాన్జీత
ਹਰ੍ਕੀਰਨ੍ਜੀਤ	హర్కీరన్జీత
ਹਰ੍ਕੀਰਪਾਲ	హర్కీరపాల
ਹਰ੍ਜਸ	హర్జస
ਹਰ੍ਤੇਇਜ	హర్తేఇజ
ਹਰ੍ਨੀਝ	హర్నీఝ
ਹਰ੍ਬਂਸ	హర్బంస
ਹਰ੍ਮਾਂਨਜਿਤ	హర్మాంనజిత
ਹਰ੍ਮਾਂਨਪਾਲ	హర్మాంనపాల
ਹਰ੍ਮੀਨ੍ਦੇਰ	హర్మీన్దేర
ਹਰ੍ਮੇਂਦ੍ਰ	హర్మేంద్ర
ਹਰ੍ਸ਼ਰ੍ਧਾ	హర్సర్ధా
ਹਰ੍ਸ਼ਵਰ੍ਧਨ	హర్సవర్ధన
ਹਰ੍ਸ਼ਾਗੁਨ	హర్సాగున
ਹਰ੍ਸਿਰਤ	హర్సిరత
ਹਸਨ	హసన
ਹਾਰਭਾਗ	హారభాగ
ਹਿਤੀਨਦੇਰ	హితీనదేర
ਹਿਤੇਨਦੇਰ	హితేనదేర
ਹਿਮ੍ਮਤ	హిమ్మత
ਹਿਰੀਸ਼	హిరీస
ਹੁਅਲੀਨਾ	హుఅలీనా
ਹੁਕੁਮਪਰਿਤ	హుకుమపరిత
ਹੂਜਓਏ	హూజఓఏ
ਹੇਤ	హేత
ਹੇਤਬੀਰ	హేతబీర
ਹੇਮੀਨਦੇਰ	హేమీనదేర
ਹੇਯ੍ਮਾਂਨ੍ਪ੍ਰਿਤ	హేయ్మాంన్ప్రిత
ਹੇਰਹੋ	హేరహో
#
#
# Territory names from CLDR
ਅਸੈਂਸ਼ਨ ਟਾਪੂ	అసైంసన టాపూ
ਅੰਡੋਰਾ	అడోరా
ਸੰਯੁਕਤ ਅਰਬ ਅਮੀਰਾਤ	సయుకత అరబ అమీరాత
ਅਫ਼ਗਾਨਿਸਤਾਨ	అఫగానిసతాన
ਐਂਟੀਗੁਆ ਅਤੇ ਬਾਰਬੁਡਾ	ఐంటీగుఆ అతే బారబుడా
ਅੰਗੁਇਲਾ	అగుఇలా
ਅਲਬਾਨੀਆ	అలబానీఆ
ਅਰਮੀਨੀਆ	అరమీనీఆ
ਅੰਗੋਲਾ	అగోలా
ਅੰਟਾਰਕਟਿਕਾ	అటారకటికా
ਅਰਜਨਟੀਨਾ	అరజనటీనా
ਅਮੈਰੀਕਨ ਸਮੋਆ	అమైరీకన సమోఆ
ਆਸਟਰੀਆ	ఆసటరీఆ
ਆਸਟ੍ਰੇਲੀਆ	ఆసట్రేలీఆ
ਅਰੂਬਾ	అరూబా
ਅਲੈਂਡ ਟਾਪੂ	అలైండ టాపూ
ਅਜ਼ਰਬਾਈਜਾਨ	అజరబాఈజాన
ਬੋਸਨੀਆ ਅਤੇ ਹਰਜ਼ੇਗੋਵੀਨਾ	బోసనీఆ అతే హరజేగోవీనా
ਬਾਰਬਾਡੋਸ	బారబాడోస
ਬੰਗਲਾਦੇਸ਼	బగలాదేస
ਬੈਲਜੀਅਮ	బైలజీఅమ
ਬੁਰਕੀਨਾ ਫ਼ਾਸੋ	బురకీనా ఫాసో
ਬੁਲਗਾਰੀਆ	బులగారీఆ
ਬਹਿਰੀਨ	బహిరీన
ਬੁਰੁੰਡੀ	బురుడీ
ਬੇਨਿਨ	బేనిన
ਸੇਂਟ ਬਾਰਥੇਲੇਮੀ	సేంట బారథేలేమీ
ਬਰਮੂਡਾ	బరమూడా
ਬਰੂਨੇਈ	బరూనేఈ
ਬੋਲੀਵੀਆ	బోలీవీఆ
ਕੈਰੇਬੀਆਈ ਨੀਦਰਲੈਂਡ	కైరేబీఆఈ నీదరలైండ
ਬ੍ਰਾਜ਼ੀਲ	బ్రాజీల
ਬਹਾਮਾਸ	బహామాస
ਭੂਟਾਨ	భూటాన
ਬੌਵੇਟ ਟਾਪੂ	బౌవేట టాపూ
ਬੋਟਸਵਾਨਾ	బోటసవానా
ਬੇਲਾਰੂਸ	బేలారూస
ਬੇਲੀਜ਼	బేలీజ
ਕੈਨੇਡਾ	కైనేడా
ਕੋਕੋਸ (ਕੀਲਿੰਗ) ਟਾਪੂ	కోకోస (కీలిగ) టాపూ
ਕਾਂਗੋ - ਕਿੰਸ਼ਾਸਾ	కాంగో - కిసాసా
ਕਾਂਗੋ ਲੋਕਤੰਤਰੀ ਗਣਰਾਜ	కాంగో లోకతతరీ గణరాజ
ਕੇਂਦਰੀ ਅਫ਼ਰੀਕੀ ਗਣਰਾਜ	కేందరీ అఫరీకీ గణరాజ
ਕਾਂਗੋ - ਬ੍ਰਾਜ਼ਾਵਿਲੇ	కాంగో - బ్రాజావిలే
ਕਾਂਗੋ ਗਣਰਾਜ	కాంగో గణరాజ
ਸਵਿਟਜ਼ਰਲੈਂਡ	సవిటజరలైండ
ਕੋਟ ਡੀਵੋਆਰ	కోట డీవోఆర
ਆਇਵਰੀ ਕੋਸਟ	ఆఇవరీ కోసట
ਕੁੱਕ ਟਾਪੂ	కుక టాపూ
ਚਿਲੀ	చిలీ
ਕੈਮਰੂਨ	కైమరూన
ਚੀਨ	చీన
ਕੋਲੰਬੀਆ	కోలబీఆ
ਕਲਿੱਪਰਟਨ ਟਾਪੂ	కలిపరటన టాపూ
ਕੋਸਟਾ ਰੀਕਾ	కోసటా రీకా
ਕਿਊਬਾ	కిఊబా
ਕੇਪ ਵਰਡੇ	కేప వరడే
ਕੁਰਾਕਾਓ	కురాకాఓ
ਕ੍ਰਿਸਮਿਸ ਟਾਪੂ	క్రిసమిస టాపూ
ਸਾਇਪ੍ਰਸ	సాఇప్రస
ਚੈਕ ਗਣਰਾਜ	చైక గణరాజ
ਜਰਮਨੀ	జరమనీ
ਡੀਇਗੋ ਗਾਰਸੀਆ	డీఇగో గారసీఆ
ਜ਼ੀਬੂਤੀ	జీబూతీ
ਡੈਨਮਾਰਕ	డైనమారక
ਡੋਮੀਨਿਕਾ	డోమీనికా
ਡੋਮੀਨਿਕਾਈ ਗਣਰਾਜ	డోమీనికాఈ గణరాజ
ਅਲਜੀਰੀਆ	అలజీరీఆ
ਸਿਓਟਾ ਅਤੇ ਮੇਲਿੱਲਾ	సిఓటా అతే మేలిలా
ਇਕਵੇਡੋਰ	ఇకవేడోర
ਇਸਟੋਨੀਆ	ఇసటోనీఆ
ਮਿਸਰ	మిసర
ਪੱਛਮੀ ਸਹਾਰਾ	పఛమీ సహారా
ਇਰੀਟ੍ਰਿਆ	ఇరీట్రిఆ
ਸਪੇਨ	సపేన
ਇਥੋਪੀਆ	ఇథోపీఆ
ਯੂਰਪੀ ਯੂਨੀਅਨ	యూరపీ యూనీఅన
ਫਿਨਲੈਂਡ	ఫినలైండ
ਫ਼ਿਜੀ	ఫిజీ
ਫ਼ਾਕਲੈਂਡ ਟਾਪੂ	ఫాకలైండ టాపూ
ਫ਼ਾਕਲੈਂਡ ਟਾਪੂ (ਆਈਲਾਸ ਮਾਲਵਿਨਾਸ)	ఫాకలైండ టాపూ (ఆఈలాస మాలవినాస)
ਮਾਇਕ੍ਰੋਨੇਸ਼ੀਆ	మాఇక్రోనేసీఆ
ਫੈਰੋ ਟਾਪੂ	ఫైరో టాపూ
ਫ਼ਰਾਂਸ	ఫరాంస
ਗਬੋਨ	గబోన
ਯੂਨਾਈਟਡ ਕਿੰਗਡਮ	యూనాఈటడ కిగడమ
ਗ੍ਰੇਨਾਡਾ	గ్రేనాడా
ਜਾਰਜੀਆ	జారజీఆ
ਫ਼ਰੈਂਚ ਗੁਆਨਾ	ఫరైంచ గుఆనా
ਗਰਨਜੀ	గరనజీ
ਘਾਨਾ	ఘానా
ਜਿਬਰਾਲਟਰ	జిబరాలటర
ਗ੍ਰੀਨਲੈਂਡ	గ్రీనలైండ
ਗੈਂਬੀਆ	గైంబీఆ
ਗਿਨੀ	గినీ
ਗੁਆਡੇਲੋਪ	గుఆడేలోప
ਭੂ-ਖੰਡੀ ਗਿਨੀ	భూ-ఖడీ గినీ
ਗ੍ਰੀਸ	గ్రీస
ਦੱਖਣੀ ਜਾਰਜੀਆ ਅਤੇ ਦੱਖਣੀ ਸੈਂਡਵਿਚ ਟਾਪੂ	దఖణీ జారజీఆ అతే దఖణీ సైండవిచ టాపూ
ਗੁਆਟੇਮਾਲਾ	గుఆటేమాలా
ਗੁਆਮ	గుఆమ
ਗਿਨੀ-ਬਿਸਾਉ	గినీ-బిసాఉ
ਗੁਯਾਨਾ	గుయానా
ਹਾਂਗ ਕਾਂਗ ਐਸਏਆਰ ਚੀਨ	హాంగ కాంగ ఐసఏఆర చీన
ਹਾਂਗ ਕਾਂਗ	హాంగ కాంగ
ਹਰਡ ਤੇ ਮੈਕਡੋਨਾਲਡ ਟਾਪੂ	హరడ తే మైకడోనాలడ టాపూ
ਹੋਂਡੁਰਸ	హోండురస
ਕਰੋਏਸ਼ੀਆ	కరోఏసీఆ
ਹੈਤੀ	హైతీ
ਹੰਗਰੀ	హగరీ
ਕੇਨਾਰੀ ਟਾਪੂ	కేనారీ టాపూ
ਇੰਡੋਨੇਸ਼ੀਆ	ఇడోనేసీఆ
ਆਇਰਲੈਂਡ	ఆఇరలైండ
ਇਜ਼ਰਾਈਲ	ఇజరాఈల
ਆਇਲ ਆਫ ਮੈਨ	ఆఇల ఆఫ మైన
ਭਾਰਤ	భారత
ਬਰਤਾਨਵੀ ਹਿੰਦ ਮਹਾਂਸਾਗਰ ਪ੍ਰਦੇਸ਼	బరతానవీ హిద మహాంసాగర ప్రదేస
ਇਰਾਕ	ఇరాక
ਈਰਾਨ	ఈరాన
ਆਈਸਲੈਂਡ	ఆఈసలైండ
ਇਟਲੀ	ఇటలీ
ਜਰਸੀ	జరసీ
ਜਮਾਇਕਾ	జమాఇకా
ਜਾਰਡਨ	జారడన
ਜਪਾਨ	జపాన
ਕੀਨੀਆ	కీనీఆ
ਕਿਰਗਿਜ਼ਸਤਾਨ	కిరగిజసతాన
ਕੰਬੋਡੀਆ	కబోడీఆ
ਕਿਰਬਾਤੀ	కిరబాతీ
ਕੋਮੋਰੋਸ	కోమోరోస
ਸੈਂਟ ਕਿਟਸ ਐਂਡ ਨੇਵਿਸ	సైంట కిటస ఐండ నేవిస
ਉੱਤਰੀ ਕੋਰੀਆ	ఉతరీ కోరీఆ
ਦੱਖਣੀ ਕੋਰੀਆ	దఖణీ కోరీఆ
ਕੁਵੈਤ	కువైత
ਕੇਮੈਨ ਟਾਪੂ	కేమైన టాపూ
ਕਜ਼ਾਖਸਤਾਨ	కజాఖసతాన
ਲਾਓਸ	లాఓస
ਲੈਬਨਾਨ	లైబనాన
ਸੇਂਟ ਲੂਸੀਆ	సేంట లూసీఆ
ਲਿਚੇਂਸਟਾਇਨ	లిచేంసటాఇన
ਸ੍ਰੀ ਲੰਕਾ	స్రీ లకా
ਲਾਈਬੀਰੀਆ	లాఈబీరీఆ
ਲੇਸੋਥੋ	లేసోథో
ਲਿਥੁਆਨੀਆ	లిథుఆనీఆ
ਲਕਜ਼ਮਬਰਗ	లకజమబరగ
ਲਾਟਵੀਆ	లాటవీఆ
ਲੀਬੀਆ	లీబీఆ
ਮੋਰੱਕੋ	మోరకో
ਮੋਨਾਕੋ	మోనాకో
ਮੋਲਡੋਵਾ	మోలడోవా
ਮੋਂਟੇਨੇਗਰੋ	మోంటేనేగరో
ਸੇਂਟ ਮਾਰਟਿਨ	సేంట మారటిన
ਮੈਡਾਗਾਸਕਰ	మైడాగాసకర
ਮਾਰਸ਼ਲ ਟਾਪੂ	మారసల టాపూ
ਮੈਕਡੋਨੀਆ	మైకడోనీఆ
ਮੈਕਡੋਨੀਆ (ਪੂਰਵ ਯੂਗੋਸਲਾਵ ਮੈਕਡੋਨੀਆਈ ਗਣਰਾਜ)	మైకడోనీఆ (పూరవ యూగోసలావ మైకడోనీఆఈ గణరాజ)
ਮਾਲੀ	మాలీ
ਮਿਆਂਮਾਰ (ਬਰਮਾ)	మిఆంమార (బరమా)
ਮੰਗੋਲੀਆ	మగోలీఆ
ਮਕਾਉ ਐਸਏਆਰ ਚੀਨ	మకాఉ ఐసఏఆర చీన
ਮਕਾਉ	మకాఉ
ਉੱਤਰੀ ਮਾਰੀਆਨਾ ਟਾਪੂ	ఉతరీ మారీఆనా టాపూ
ਮਾਰਟੀਨਿਕ	మారటీనిక
ਮੋਰਿਟਾਨੀਆ	మోరిటానీఆ
ਮੋਂਟਸੇਰਾਤ	మోంటసేరాత
ਮਾਲਟਾ	మాలటా
ਮੌਰਿਸ਼ਸ	మౌరిసస
ਮਾਲਦੀਵ	మాలదీవ
ਮਲਾਵੀ	మలావీ
ਮੈਕਸੀਕੋ	మైకసీకో
ਮਲੇਸ਼ੀਆ	మలేసీఆ
ਮੋਜ਼ਾਮਬੀਕ	మోజామబీక
ਨਾਮੀਬੀਆ	నామీబీఆ
ਨਿਊ ਕੈਲੇਡੋਨੀਆ	నిఊ కైలేడోనీఆ
ਨਾਈਜਰ	నాఈజర
ਨੋਰਫੌਕ ਟਾਪੂ	నోరఫౌక టాపూ
ਨਾਈਜੀਰੀਆ	నాఈజీరీఆ
ਨਿਕਾਰਾਗੁਆ	నికారాగుఆ
ਨੀਦਰਲੈਂਡ	నీదరలైండ
ਨਾਰਵੇ	నారవే
ਨੇਪਾਲ	నేపాల
ਨਾਉਰੂ	నాఉరూ
ਨਿਯੂ	నియూ
ਨਿਊਜ਼ੀਲੈਂਡ	నిఊజీలైండ
ਓਮਾਨ	ఓమాన
ਪਨਾਮਾ	పనామా
ਪੇਰੂ	పేరూ
ਫਰੈਂਚ ਪੋਲੀਨੇਸ਼ੀਆ	ఫరైంచ పోలీనేసీఆ
ਪਾਪੂਆ ਨਿਊ ਗਿਨੀ	పాపూఆ నిఊ గినీ
ਫਿਲੀਪੀਂਸ	ఫిలీపీంస
ਪਾਕਿਸਤਾਨ	పాకిసతాన
ਪੋਲੈਂਡ	పోలైండ
ਸੈਂਟ ਪੀਅਰੇ ਐਂਡ ਮਿਕੇਲਨ	సైంట పీఅరే ఐండ మికేలన
ਪਿਟਕੇਰਨ ਟਾਪੂ	పిటకేరన టాపూ
ਪਿਊਰਟੋ ਰਿਕੋ	పిఊరటో రికో
ਫਿਲੀਸਤੀਨੀ ਖੇਤਰ	ఫిలీసతీనీ ఖేతర
ਫਿਲੀਸਤੀਨ	ఫిలీసతీన
ਪੁਰਤਗਾਲ	పురతగాల
ਪਲਾਉ	పలాఉ
ਪੈਰਾਗਵੇ	పైరాగవే
ਕਤਰ	కతర
ਆਊਟਲਾਇੰਗ ਓਸ਼ੀਨੀਆ	ఆఊటలాఇగ ఓసీనీఆ
ਰਿਯੂਨੀਅਨ	రియూనీఅన
ਰੋਮਾਨੀਆ	రోమానీఆ
ਸਰਬੀਆ	సరబీఆ
ਰੂਸ	రూస
ਰਵਾਂਡਾ	రవాండా
ਸਾਊਦੀ ਅਰਬ	సాఊదీ అరబ
ਸੋਲੋਮਨ ਟਾਪੂ	సోలోమన టాపూ
ਸੇਸ਼ਲਸ	సేసలస
ਸੂਡਾਨ	సూడాన
ਸਵੀਡਨ	సవీడన
ਸਿੰਗਾਪੁਰ	సిగాపుర
ਸੇਂਟ ਹੇਲੇਨਾ	సేంట హేలేనా
ਸਲੋਵੇਨੀਆ	సలోవేనీఆ
ਸਵਾਲਬਰਡ ਅਤੇ ਜਾਨ ਮਾਯੇਨ	సవాలబరడ అతే జాన మాయేన
ਸਲੋਵਾਕੀਆ	సలోవాకీఆ
ਸਿਏਰਾ ਲਿਓਨ	సిఏరా లిఓన
ਸੈਨ ਮਰੀਨੋ	సైన మరీనో
ਸੇਨੇਗਲ	సేనేగల
ਸੋਮਾਲੀਆ	సోమాలీఆ
ਸੂਰੀਨਾਮ	సూరీనామ
ਦੱਖਣੀ ਸੂਡਾਨ	దఖణీ సూడాన
ਸਾਓ ਟੋਮ ਅਤੇ ਪ੍ਰਿੰਸੀਪੇ	సాఓ టోమ అతే ప్రిసీపే
ਅਲ ਸਲਵਾਡੋਰ	అల సలవాడోర
ਸਿੰਟ ਮਾਰਟੀਨ	సిట మారటీన
ਸੀਰੀਆ	సీరీఆ
ਸਵਾਜ਼ੀਲੈਂਡ	సవాజీలైండ
ਟ੍ਰਿਸਟਾਨ ਦਾ ਕੁੰਹਾ	ట్రిసటాన దా కుహా
ਟੁਰਕਸ ਅਤੇ ਕੈਕੋਸ ਟਾਪੂ	టురకస అతే కైకోస టాపూ
ਚਾਡ	చాడ
ਫਰੈਂਚ ਦੱਖਣੀ ਪ੍ਰਦੇਸ਼	ఫరైంచ దఖణీ ప్రదేస
ਟੋਗੋ	టోగో
ਥਾਈਲੈਂਡ	థాఈలైండ
ਤਾਜਿਕਿਸਤਾਨ	తాజికిసతాన
ਟੋਕੇਲਾਉ	టోకేలాఉ
ਤਿਮੋਰ-ਲੇਸਤੇ	తిమోర-లేసతే
ਪੂਰਬੀ ਤਿਮੋਰ	పూరబీ తిమోర
ਤੁਰਕਮੇਨਿਸਤਾਨ	తురకమేనిసతాన
ਟਿਊਨੀਸ਼ੀਆ	టిఊనీసీఆ
ਟੌਂਗਾ	టౌంగా
ਤੁਰਕੀ	తురకీ
ਟ੍ਰਿਨੀਡਾਡ ਅਤੇ ਟੋਬਾਗੋ	ట్రినీడాడ అతే టోబాగో
ਟੁਵਾਲੂ	టువాలూ
ਤਾਇਵਾਨ	తాఇవాన
ਤਨਜ਼ਾਨੀਆ	తనజానీఆ
ਯੂਕਰੇਨ	యూకరేన
ਯੂਗਾਂਡਾ	యూగాండా
ਸੰਯੁਕਤ ਰਾਜ	సయుకత రాజ
ਉਰੂਗਵੇ	ఉరూగవే
ਉਜ਼ਬੇਕਿਸਤਾਨ	ఉజబేకిసతాన
ਵੈਟੀਕਨ ਸਿਟੀ	వైటీకన సిటీ
ਸੇਂਟ ਵਿਨਸੈਂਟ ਐਂਡ ਗ੍ਰੇਨਾਡੀਨਸ	సేంట వినసైంట ఐండ గ్రేనాడీనస
ਵੇਨੇਜ਼ੂਏਲਾ	వేనేజూఏలా
ਬ੍ਰਿਟਿਸ਼ ਵਰਜਿਨ ਟਾਪੂ	బ్రిటిస వరజిన టాపూ
ਯੂ ਐਸ ਵਰਜਿਨ ਟਾਪੂ	యూ ఐస వరజిన టాపూ
ਵੀਅਤਨਾਮ	వీఅతనామ
ਵਾਨੂਆਟੂ	వానూఆటూ
ਵਾਲਿਸ ਅਤੇ ਫੂਟੂਨਾ	వాలిస అతే ఫూటూనా
ਸਾਮੋਆ	సామోఆ
ਕੋਸੋਵੋ	కోసోవో
ਯਮਨ	యమన
ਮਾਯੋਟੀ	మాయోటీ
ਦੱਖਣੀ ਅਫਰੀਕਾ	దఖణీ అఫరీకా
ਜ਼ਾਮਬੀਆ	జామబీఆ
ਜ਼ਿੰਬਾਬਵੇ	జిబాబవే
ਅਣਪਛਾਤਾ ਖੇਤਰ	అణపఛాతా ఖేతర
