# Baby names
ਅਂਗਦ	ಅಂಗದ
ਅਂਗਦ ਦੇਵ	ಅಂಗದ ದೇವ
ਅਂਗਾਰਿਕਾ	ಅಂಗಾರಿಕಾ
ਅਂਤਰਜੋਤ	ಅಂತರಜೋತ
ਅਂਤਰਪ੍ਰਿਤ	ಅಂತರಪ್ರಿತ
ਅਂਤਰਾ	ಅಂತರಾ
ਅਕਲਤਟ	ಅಕಲತಟ
ਅਕਲਰੂਪ	ಅಕಲರೂಪ
ਅਕਲਸ਼ਰਣ	ಅಕಲಸ಼ರಣ
ਅਕਲਸੀਮਾਰ	ಅಕಲಸೀಮಾರ
ਅਕਾਲਜੋਗ	ಅಕಾಲಜೋಗ
ਅਕਾਲਦੀਪ	ಅಕಾಲದೀಪ
ਅਕਾਲਪ੍ਰੀਤ	ಅಕಾಲಪ್ರೀತ
ਅਕਾਲਬੀਰ	ಅಕಾಲಬೀರ
ਅਗਮਜੀਤ	ಅಗಮಜೀತ
ਅਗਮਜੋਤ	ಅಗಮಜೋತ
ਅਗਮ੍ਪਾਲ	ಅಗಮ್ಪಾಲ
ਅਗਮ੍ਪ੍ਰੀਤ	ಅಗಮ್ಪ್ರೀತ
ਅਜ੍ਮੀਨ੍ਦੇਰ	ಅಜ್ಮೀನ್ದೇರ
ਅਝਾਦਬੀਰ	ಅಝಾದಬೀರ
ਅਝੀਝ	ಅಝೀಝ
ਅਤੀਨਦੇਰ੍ਜਿਤ	ಅತೀನದೇರ್ಜಿತ
ਅਤੀਨ੍ਦੇਰ	ಅತೀನ್ದೇರ
ਅਤ੍ਤਾਮਜਿਤ	ಅತ್ತಾಮಜಿತ
ਅਨਂਤਦੇਵ	ಅನಂತದೇವ
ਅਨਂਤਰ	ಅನಂತರ
ਅਨਂਤਵੀਰ	ಅನಂತವೀರ
ਅਨਂਤ੍ਜੀਤ	ಅನಂತ್ಜೀತ
ਅਨਾਹਤ	ಅನಾಹತ
ਅਨਿਂਦਿਤਾ	ಅನಿಂದಿತಾ
ਅਨਿਸ਼ਾ	ಅನಿಸ಼ಾ
ਅਨੀਲਜੋਤ	ಅನೀಲಜೋತ
ਅਨੀਸ਼੍ਕੋਉਂਰ	ಅನೀಸ಼್ಕೋಉಂರ
ਅਨੁਂਜਪਾਲ	ಅನುಂಜಪಾಲ
ਅਨੁਂਪਜੋਤ	ಅನುಂಪಜೋತ
ਅਨੁਰਾਧਾ	ಅನುರಾಧಾ
ਅਨੁਸ਼੍ਕਾ	ಅನುಸ಼್ಕಾ
ਅਨੂਪਜੋਤ	ಅನೂಪಜೋತ
ਅਨੂਪਬੀਰ	ಅನೂಪಬೀರ
ਅਨੂਪਲੋਕ	ಅನೂಪಲೋಕ
ਅਪੂਰ੍ਵਾ	ಅಪೂರ್ವಾ
ਅਪ੍ਰੀਨਦੇਰ	ಅಪ್ರೀನದೇರ
ਅਬਨੀ	ಅಬನೀ
ਅਬਿਚਾਲ	ಅಬಿಚಾಲ
ਅਬਿਨਾਸ਼	ಅಬಿನಾಸ಼
ਅਭਿਜੀਤ	ಅಭಿಜೀತ
ਅਭਿਰੂਪ	ಅಭಿರೂಪ
ਅਮਨਜੀਤ	ಅಮನಜೀತ
ਅਮਰਜੋਤ	ಅಮರಜೋತ
ਅਮਰਤ	ಅಮರತ
ਅਮਰਿਂਦਰ	ಅಮರಿಂದರ
ਅਮਰਿਤ	ಅಮರಿತ
ਅਮਲਜੋਤ	ಅಮಲಜೋತ
ਅਮਾਨਜੀਵਨ	ಅಮಾನಜೀವನ
ਅਮਾਨੀਨ੍ਦੇਰ	ಅಮಾನೀನ್ದೇರ
ਅਮਾਨ੍ਰੂਪ	ಅಮಾನ್ರೂಪ
ਅਮਾਰ੍ਪਾਲ	ಅಮಾರ್ಪಾಲ
ਅਮਾਰ੍ਬੀਰ	ಅಮಾರ್ಬೀರ
ਅਮਿਕ	ಅಮಿಕ
ਅਮਿਤ	ಅಮಿತ
ਅਮਿਤੋਜ	ಅಮಿತೋಜ
ਅਮੀਤਪਾਲ	ಅಮೀತಪಾಲ
ਅਮੀਤ੍ਬੀਰ	ಅಮೀತ್ಬೀರ
ਅਮੋਲ੍ਰਸ	ಅಮೋಲ್ರಸ
ਅਮ੍ਨੀਨ੍ਦੇਰ	ಅಮ್ನೀನ್ದೇರ
ਅਮ੍ਰੀਤਬਾਨ	ಅಮ್ರೀತಬಾನ
ਅਮ੍ਰੀਤ੍ਪ੍ਰਿਤ	ಅಮ್ರೀತ್ಪ್ರಿತ
ਅਮ੍ਰੀਤ੍ਵਾਨੀ	ಅಮ್ರೀತ್ವಾನೀ
ਅਰਮਾਨੀ	ಅರಮಾನೀ
ਅਰਵਜੋਤ	ಅರವಜೋತ
ਅਰੀਨਾਜੇਤ	ಅರೀನಾಜೇತ
ਅਰੀਨ੍ਦੇਰ੍ਜੀਤ	ಅರೀನ್ದೇರ್ಜೀತ
ਅਰੁਨਜੀਤ	ಅರುನಜೀತ
ਅਰੁਨਜੋਤ	ಅರುನಜೋತ
ਅਰ੍ਚਨਾ	ಅರ್ಚನಾ
ਅਰ੍ਦਮਨ	ಅರ್ದಮನ
ਅਰ੍ਨਾਲੀਨ੍ਦੇਰ	ಅರ್ನಾಲೀನ್ದೇರ
ਅਰ੍ਸ਼੍ਦੀਪ	ಅರ್ಸ಼್ದೀಪ
ਅਲੋਕ੍ਪਾਲ	ಅಲೋಕ್ಪಾಲ
ਅਲ੍ਪਨਾ	ಅಲ್ಪನಾ
ਅਵਨੀਨਦੇਰ	ಅವನೀನದೇರ
ਅਵਿਰ	ಅವಿರ
ਅਵ੍ਲੀਨ	ಅವ್ಲೀನ
ਅਸਂਖ	ಅಸಂಖ
ਅਸ਼ਮਿਤ	ಅಸ಼ಮಿತ
ਅਸ਼ਰ੍ਨਾਮ	ಅಸ಼ರ್ನಾಮ
ਅਸ਼ਰ੍ਪ੍ਰੀਤ	ಅಸ಼ರ್ಪ್ರೀತ
ਅਸ਼ਰ੍ਪ੍ਰੇਮ	ಅಸ಼ರ್ಪ್ರೇಮ
ਅਸ਼ਰ੍ਵੀਰ	ಅಸ಼ರ್ವೀರ
ਅਸ਼ਿਮਾ	ಅಸ಼ಿಮಾ
ਅਸੀਮ	ಅಸೀಮ
ਅਸੀਸ	ಅಸೀಸ
ਅਸ੍ਨੇਹ	ಅಸ್ನೇಹ
ਆਖਰੀ	ಆಖರೀ
ਆਤ੍ਮਜਾ	ಆತ್ಮಜಾ
ਆਨਂਦਮਯੀ	ಆನಂದಮಯೀ
ਆਨਂਦਰੂਪ	ಆನಂದರೂಪ
ਆਯਕਾਰ	ಆಯಕಾರ
ਆਯਾਤਪ੍ਰਿਤ	ಆಯಾತಪ್ರಿತ
ਆਯੁਸ਼੍ਮਤਿ	ಆಯುಸ಼್ಮತಿ
ਆਰਮਾਨ	ಆರಮಾನ
ਆਰਾਧ	ಆರಾಧ
ਆਰਾਧਨਾ	ಆರಾಧನಾ
ਆਰ੍ਯਨ	ಆರ್ಯನ
ਇਂਦਰਬੀਰ	ಇಂದರಬೀರ
ਇਂਦਿਵਰ	ಇಂದಿವರ
ਇਕਪ੍ਰਿਤ	ಇಕಪ್ರಿತ
ਇਕਬਾਲ	ಇಕಬಾಲ
ਇਕਰੂਪ	ಇಕರೂಪ
ਇਕ੍ਪੂਜ	ಇಕ್ಪೂಜ
ਇਕ੍ਮਾਨ	ಇಕ್ಮಾನ
ਇਚ੍ਕਜਿਤ	ಇಚ್ಕಜಿತ
ਇਨ੍ਦਾਰਤੇਜ	ಇನ್ದಾರತೇಜ
ਇਨ੍ਦਾਰਮਿਤ	ಇನ್ದಾರಮಿತ
ਇਨ੍ਦਾਰ੍ਦੀਪ	ಇನ್ದಾರ್ದೀಪ
ਇਨ੍ਦਾਰ੍ਪ੍ਰਿਤ	ಇನ್ದಾರ್ಪ್ರಿತ
ਇਨ੍ਦਾਰ੍ਪ੍ਰੇਮ	ಇನ್ದಾರ್ಪ್ರೇಮ
ਇਨ੍ਦੇਰ	ಇನ್ದೇರ
ਇਨ੍ਦੇਰਪਲ	ಇನ್ದೇರಪಲ
ਇਨ੍ਦੇਰਮਾਨ	ಇನ್ದೇರಮಾನ
ਇਨ੍ਦੇਰਹਾਰ੍ਜਿਤ	ಇನ್ದೇರಹಾರ್ಜಿತ
ਇਮਰਾਤ	ಇಮರಾತ
ਈਖ੍ਤਿਅਰ	ಈಖ್ತಿಅರ
ਈਨ੍ਦਰ੍ਜੀਏਤ	ಈನ್ದರ್ಜೀಏತ
ਈਨ੍ਦੇਰਤੇਕ	ಈನ್ದೇರತೇಕ
ਈਨ੍ਦੇਰਵੀਰ	ಈನ್ದೇರವೀರ
ਈਬਾਦਤ	ಈಬಾದತ
ਈਸ਼ਪਾਲ	ಈಸ಼ಪಾಲ
ਈਸ਼ਲੀਨ	ಈಸ಼ಲೀನ
ਈਸ਼ਾਰਤੇਕ	ಈಸ಼ಾರತೇಕ
ਈਸ਼ਾਰਪਾਲ	ಈಸ಼ಾರಪಾಲ
ਈਸ਼੍ਤ੍ਵਰ੍ਜਿਤ	ಈಸ಼್ತ್ವರ್ಜಿತ
ਈਸ਼੍ਪ੍ਰਿਤ	ಈಸ಼್ಪ್ರಿತ
ਈਸ਼੍ਵਾਰ੍ਜਿਤ	ಈಸ಼್ವಾರ್ಜಿತ
ਈਸ਼੍ਵੀਨਦੇਰ	ಈಸ಼್ವೀನದೇರ
ਉਖ੍ਤਿਅਰ	ಉಖ್ತಿಅರ
ਉਚਪਾਲ	ಉಚಪಾಲ
ਉਚਪ੍ਰਿਤ	ಉಚಪ್ರಿತ
ਉਚੀਤਦੀਪ	ಉಚೀತದೀಪ
ਉਚੀਤਪ੍ਰਿਤ	ಉಚೀತಪ್ರಿತ
ਉਚੀਤਬੀਰ	ಉಚೀತಬೀರ
ਉਚੀਤਰੂਪ	ಉಚೀತರೂಪ
ਉਚੀਤਲੋਕ	ಉಚೀತಲೋಕ
ਉਚੀਤਵਂਤ	ಉಚೀತವಂತ
ਉਜਗਰ੍ਜੋਤ	ಉಜಗರ್ಜೋತ
ਉਜਗਰ੍ਦੀਪ	ಉಜಗರ್ದೀಪ
ਉਜਗਰ੍ਬੀਰ	ಉಜಗರ್ಬೀರ
ਉਜਾਗਰ	ಉಜಾಗರ
ਉਜਾਲਾ	ಉಜಾಲಾ
ਉਜ੍ਜਲਜੋਤ	ಉಜ್ಜಲಜೋತ
ਉਤ੍ਤਮ	ಉತ್ತಮ
ਉਤ੍ਤਮਪਾਲ	ಉತ್ತಮಪಾಲ
ਉਤ੍ਤਮਲੀਵ	ಉತ್ತಮಲೀವ
ਉਤ੍ਤਾਮਕਾਰਾਮ	ಉತ್ತಾಮಕಾರಾಮ
ਉਤ੍ਤਾਮਜੋਧ	ಉತ್ತಾಮಜೋಧ
ਉਤ੍ਤਾਮਤਿਰਥ	ಉತ್ತಾಮತಿರಥ
ਉਤ੍ਤਾਮਤੇਕ	ಉತ್ತಾಮತೇಕ
ਉਤ੍ਤਾਮਦੀਪ	ಉತ್ತಾಮದೀಪ
ਉਤ੍ਤਾਮਪਦ	ಉತ್ತಾಮಪದ
ਉਤ੍ਤਾਮ੍ਰਸ	ಉತ್ತಾಮ್ರಸ
ਉਤ੍ਤਾਮ੍ਰੂਪ	ಉತ್ತಾಮ್ರೂಪ
ਉਤ੍ਰਕ੍ਸ਼	ಉತ್ರಕ್ಸ಼
ਉਦੀਤਦੀਪ	ಉದೀತದೀಪ
ਉਦੀਤਪ੍ਰਿਤ	ಉದೀತಪ್ರಿತ
ਉਦੀਤਬੀਰ	ಉದೀತಬೀರ
ਉਦੈਬੀਰ	ಉದೈಬೀರ
ਉਦੈਭਗਤ	ಉದೈಭಗತ
ਉਦ੍ਦਾਮਜੀਤ	ಉದ್ದಾಮಜೀತ
ਉਪਕਰਮ	ಉಪಕರಮ
ਉਪਕਿਰਤ	ಉಪಕಿರತ
ਉਪਜਿਤ	ಉಪಜಿತ
ਉਪਨਿਤ	ಉಪನಿತ
ਉਪੀਨਦੇਰ੍ਪ੍ਰਿਤ	ಉಪೀನದೇರ್ಪ್ರಿತ
ਉਪੇਨ੍ਦੇਰ	ಉಪೇನ್ದೇರ
ਉਮੀਦ	ಉಮೀದ
ਊਤ੍ਤਮ੍ਗਿਆਨ	ಊತ್ತಮ್ಗಿಆನ
ਏਕਂਕਰ	ಏಕಂಕರ
ਏਕਬੀਰ	ಏಕಬೀರ
ਏਕਮ	ಏಕಮ
ਏਕਮਪੂਜ	ಏಕಮಪೂಜ
ਏਕਮਬੀਰ	ಏಕಮಬೀರ
ਏਕਮ੍ਜੋਤ	ಏಕಮ್ಜೋತ
ਏਕਮ੍ਰੂਪ	ಏಕಮ್ರೂಪ
ਏਕਾਨਪ੍ਰੀਤ	ಏಕಾನಪ್ರೀತ
ਏਕ੍ਕਾਮ	ಏಕ್ಕಾಮ
ਏਤੀਬਾਰ	ಏತೀಬಾರ
ਏਤ੍ਤਲੀਨ	ಏತ್ತಲೀನ
ਏਰਸ਼ੀਨ	ಏರಸ಼ೀನ
ਏਵੇਨਿਤ	ಏವೇನಿತ
ਏਸ਼ਨਾ	ಏಸ಼ನಾ
ਏਸ਼੍ਵਰ	ಏಸ಼್ವರ
ਓਨਕਾਰ੍ਜਿਤ	ಓನಕಾರ್ಜಿತ
ਓਨਕਾਰ੍ਜੀਤ	ಓನಕಾರ್ಜೀತ
ਓਨਕਾਰ੍ਪ੍ਰਿਤ	ಓನಕಾರ್ಪ್ರಿತ
ਓਮਪ੍ਰਿਤ	ಓಮಪ್ರಿತ
ਕਂਵਲ	ಕಂವಲ
ਕਂਵਲਜੀਤ	ಕಂವಲಜೀತ
ਕਨਵਾਰ੍ਜਾਗਤ	ಕನವಾರ್ಜಾಗತ
ਕਨਵਾਰ੍ਜਿਤ	ಕನವಾರ್ಜಿತ
ਕਨਵਾਰ੍ਪ੍ਰੇਮ	ಕನವಾರ್ಪ್ರೇಮ
ਕਨਵਾਲ੍ਜੋਤ	ಕನವಾಲ್ಜೋತ
ਕਨਵਾਲ੍ਨੈਨ	ಕನವಾಲ್ನೈನ
ਕਨਵਾਲ੍ਪਾਲ	ಕನವಾಲ್ಪಾಲ
ਕਨਵਾਲ੍ਪ੍ਰੇਮ	ಕನವಾಲ್ಪ್ರೇಮ
ਕਨਵਾਲ੍ਬੀਰ	ಕನವಾಲ್ಬೀರ
ਕਨਵਾਲ੍ਰੂਪ	ಕನವಾಲ್ರೂಪ
ਕਨ੍ਚਨ੍ਦੀਪ	ಕನ್ಚನ್ದೀಪ
ਕਨ੍ਚਾਨ੍ਪਾਲ	ಕನ್ಚಾನ್ಪಾಲ
ਕਨ੍ਵਾਰਪਾਲ	ಕನ್ವಾರಪಾಲ
ਕਮਾਲ੍ਲਾ	ಕಮಾಲ್ಲಾ
ਕਰਨਦੀਪ	ಕರನದೀಪ
ਕਰਨਪਾਲ	ಕರನಪಾಲ
ਕਰਨਪ੍ਰਿਤ	ಕರನಪ್ರಿತ
ਕਰਨਰੂਪ	ಕರನರೂಪ
ਕਰਮਪਲ	ಕರಮಪಲ
ਕਰਮਪੁਲ	ಕರಮಪುಲ
ਕਰਮ੍ਜੋਤ	ಕರಮ್ಜೋತ
ਕਰੁਨ੍ਯਾ	ಕರುನ್ಯಾ
ਕਲਬੀਰ	ಕಲಬೀರ
ਕਲਾਜੋਤ	ಕಲಾಜೋತ
ਕਲਾਪ੍ਰੇਮ	ಕಲಾಪ್ರೇಮ
ਕਵਨਿਤ	ಕವನಿತ
ਕਵਨੀਰ	ಕವನೀರ
ਕਵਾਲ੍ਨਾਨ	ಕವಾಲ್ನಾನ
ਕਵਿਰਾਜ	ಕವಿರಾಜ
ਕਸਮ	ಕಸಮ
ਕਾਨਵਾਲੀਨ੍ਦੇਰ	ಕಾನವಾಲೀನ್ದೇರ
ਕਾਮਾਂਲਜੋਤ	ಕಾಮಾಂಲಜೋತ
ਕਾਮਾਂਲਮਿਤ	ಕಾಮಾಂಲಮಿತ
ਕਾਮਾਂਲਮੋਹਨ	ಕಾಮಾಂಲಮೋಹನ
ਕਾਮਾਂਲ੍ਪਤਿ	ಕಾಮಾಂಲ್ಪತಿ
ਕਾਰਮਨ	ಕಾರಮನ
ਕਾਵਾਲਪ੍ਰਿਤ	ಕಾವಾಲಪ್ರಿತ
ਕਿਰਣਜੀਤ	ಕಿರಣಜೀತ
ਕਿਰਨਰੂਪ	ಕಿರನರೂಪ
ਕਿਰਨਸੁਖ	ಕಿರನಸುಖ
ਕਿਸ਼ੇਨ	ಕಿಸ಼ೇನ
ਕੁਂਵਰਜੀਤ	ಕುಂವರಜೀತ
ਕੁਲ	ಕುಲ
ਕੁਲਜੋਤ	ಕುಲಜೋತ
ਕੁਲਮਿਤ	ಕುಲಮಿತ
ਕੁਲਰਾਤਨ	ಕುಲರಾತನ
ਕੁਲਰੂਪ	ಕುಲರೂಪ
ਕੁਲਵਂਠ	ಕುಲವಂಠ
ਕੁਸ਼ਪ੍ਰਿਤ	ಕುಸ಼ಪ್ರಿತ
ਕੇਵਾਲਦੀਪ	ಕೇವಾಲದೀಪ
ਕੇਵਾਲਬੀਰ	ಕೇವಾಲಬೀರ
ਕੋਉਰ	ಕೋಉರ
ਕੋਮਾਂਲਜੀਤ	ಕೋಮಾಂಲಜೀತ
ਕੋਮਾਂਲਪ੍ਰੇਮ	ಕೋಮಾಂಲಪ್ರೇಮ
ਕੋਮਾਲਦੀਪ	ಕೋಮಾಲದೀಪ
ਕੋਮਾਲਮਿਤ	ಕೋಮಾಲಮಿತ
ਕੌਰ	ಕೌರ
ਕ੍ਰਿਸ਼੍ਦੀਪ	ಕ್ರಿಸ಼್ದೀಪ
ਕ੍ਸ਼ਾਗਨ	ಕ್ಸ಼ಾಗನ
ਕ੍ਸ਼ਾਗਰ	ಕ್ಸ಼ಾಗರ
ਕ੍ਸ਼ਿਤਿਜ	ಕ್ಸ಼ಿತಿಜ
ਕ੍ਸ਼੍ਹੀਮ	ಕ್ಸ಼್ಹೀಮ
ਖਰਗ	ಖರಗ
ਖਾਲਾਕ੍ਵੀਰ	ಖಾಲಾಕ್ವೀರ
ਖੁਂਸ਼ਜੋਤ	ಖುಂಸ಼ಜೋತ
ਖੁਸ	ಖುಸ
ਖੁਸ਼	ಖುಸ಼
ਖੁਸ਼ਜੀਤ	ಖುಸ಼ಜೀತ
ਖੇਮਵਂਤ	ಖೇಮವಂತ
ਗਗਨ	ಗಗನ
ਗਗਨਜੀਵ	ಗಗನಜೀವ
ਗਗਨਜੋਤ	ಗಗನಜೋತ
ਗਗਨਪ੍ਰਿਤ	ಗಗನಪ್ರಿತ
ਗਗਨਮਿਤ	ಗಗನಮಿತ
ਗਤਲੀਨ	ಗತಲೀನ
ਗਤਸ਼ਰਣ	ಗತಸ಼ರಣ
ਗਤਸੀਮਾਰ	ಗತಸೀಮಾರ
ਗਰੀਨ੍ਦੇਰ	ಗರೀನ್ದೇರ
ਗਰ੍ਗੋਤ	ಗರ್ಗೋತ
ਗਾਤਨੀਵਾਸ	ಗಾತನೀವಾಸ
ਗਿਅਨ	ಗಿಅನ
ਗੀਂਜੀਵਨ	ಗೀಂಜೀವನ
ਗੀਂਰਾਤਨ	ಗೀಂರಾತನ
ਗੀਂਲੀਨ	ಗೀಂಲೀನ
ਗੀਅਂਗੀਤ	ಗೀಅಂಗೀತ
ਗੀਅਂਚੇਤਨ	ಗೀಅಂಚೇತನ
ਗੀਅਂਜੋਤ	ಗೀಅಂಜೋತ
ਗੀਅਂਪ੍ਰਿਤ	ಗೀಅಂಪ್ರಿತ
ਗੀਅਂਰੂਪ	ಗೀಅಂರೂಪ
ਗੀਅਨੀਨਦੇਰ	ಗೀಅನೀನದೇರ
ਗੀਅਨ੍ਬੀਰ	ಗೀಅನ್ಬೀರ
ਗੀਆਨਪ੍ਰਿਤ	ಗೀಆನಪ್ರಿತ
ਗੀਆਨਲੀਨ	ಗೀಆನಲೀನ
ਗੀਤ	ಗೀತ
ਗੀਤਲੀਨ	ಗೀತಲೀನ
ਗੀਤੀਨਦੇਰ	ಗೀತೀನದೇರ
ਗੁਣਿਤ	ಗುಣಿತ
ਗੁਨ ਦਾਤ	ಗುನ ದಾತ
ਗੁਨਕਿਰਤ	ಗುನಕಿರತ
ਗੁਨਜਸ	ಗುನಜಸ
ਗੁਨਜਿਤ	ಗುನಜಿತ
ਗੁਨਜੀਵਨ	ಗುನಜೀವನ
ਗੁਨਜੁਨ	ಗುನಜುನ
ਗੁਨਜੋਤ	ಗುನಜೋತ
ਗੁਨਪ੍ਰਿਤ	ಗುನಪ್ರಿತ
ਗੁਨਮਿਤ	ಗುನಮಿತ
ਗੁਨਰਾਜ	ಗುನರಾಜ
ਗੁਨਸ਼ਾਂਤ	ಗುನಸ಼ಾಂತ
ਗੁਨਾਤਮ	ಗುನಾತಮ
ਗੁਨਿਤਪੁਲ	ಗುನಿತಪುಲ
ਗੁਨਿਤਪ੍ਰਿਤ	ಗುನಿತಪ್ರಿತ
ਗੁਨ੍ਰਿਤ	ಗುನ್ರಿತ
ਗੁਰਕਮਲ਼	ಗುರಕಮಲ಼
ਗੁਰਗਿਯਨ	ಗುರಗಿಯನ
ਗੁਰਜਾਸ	ಗುರಜಾಸ
ਗੁਰਜੀਵਨ	ಗುರಜೀವನ
ਗੁਰਜੋਗ	ಗುರಜೋಗ
ਗੁਰਜੋਤ	ಗುರಜೋತ
ਗੁਰਝੀਲ	ಗುರಝೀಲ
ਗੁਰਤਰਣ	ಗುರತರಣ
ਗੁਰਤਿਰਥ	ಗುರತಿರಥ
ਗੁਰਦਰ੍ਸ਼ਨ	ಗುರದರ್ಸ಼ನ
ਗੁਰਦਿਤ	ಗುರದಿತ
ਗੁਰਦੀਤ੍ਤਾ	ಗುರದೀತ್ತಾ
ਗੁਰਦ੍ਵੀਪ	ಗುರದ್ವೀಪ
ਗੁਰਨਾਦ	ಗುರನಾದ
ਗੁਰਨਾਮਾਸ੍ਕਾਰ	ಗುರನಾಮಾಸ್ಕಾರ
ਗੁਰਨੀਧ	ಗುರನೀಧ
ਗੁਰਨੀਰ੍ਮਾਲ	ಗುರನೀರ್ಮಾಲ
ਗੁਰਨੀਸ਼ਾਨ	ಗುರನೀಸ಼ಾನ
ਗੁਰਨ੍ਯਮ	ಗುರನ್ಯಮ
ਗੁਰਪਰ੍ਵਿਨ	ಗುರಪರ್ವಿನ
ਗੁਰਪੀਨਦੇਰ	ಗುರಪೀನದೇರ
ਗੁਰਪ੍ਰੀਤਮ	ಗುರಪ್ರೀತಮ
ਗੁਰਬਕ੍ਸ਼	ಗುರಬಕ್ಸ಼
ਗੁਰਬਲੀਹਾਰ	ಗುರಬಲೀಹಾರ
ਗੁਰਬੀਨ੍ਦੇਰ	ಗುರಬೀನ್ದೇರ
ਗੁਰਬੀਰ	ಗುರಬೀರ
ਗੁਰਭਜਨ	ಗುರಭಜನ
ਗੁਰਭਾਗਤ	ಗುರಭಾಗತ
ਗੁਰਮਾਰ	ಗುರಮಾರ
ਗੁਰਮਾਹੇਰ	ಗುರಮಾಹೇರ
ਗੁਰਮੁਖ	ಗುರಮುಖ
ਗੁਰਮੇਹਾਰ	ಗುರಮೇಹಾರ
ਗੁਰਮੈਲ	ಗುರಮೈಲ
ਗੁਰਮ੍ਰਿਤ	ಗುರಮ್ರಿತ
ਗੁਰਲੋਚਨ	ಗುರಲೋಚನ
ਗੁਰਵਿਂਦਰ	ಗುರವಿಂದರ
ਗੁਰਵੀਨ੍ਦੇਰ	ಗುರವೀನ್ದೇರ
ਗੁਰਵੀਰ	ಗುರವೀರ
ਗੁਰਸਨ੍ਦੀਪ	ಗುರಸನ್ದೀಪ
ਗੁਰਸ਼ਾਨ	ಗುರಸ಼ಾನ
ਗੁਰਸੁਖ	ಗುರಸುಖ
ਗੁਰਸੇਵ	ಗುರಸೇವ
ਗੁਰਹਾਰ੍ਪਾਲ	ಗುರಹಾರ್ಪಾಲ
ਗੁਰਿਂਦਰ	ಗುರಿಂದರ
ਗੁਰੀਨਦੇਰ੍ਪਾਲ	ಗುರೀನದೇರ್ಪಾಲ
ਗੁਰੁਕਾਰ	ಗುರುಕಾರ
ਗੁਰੁਗੁਲ੍ਝਾਰ	ಗುರುಗುಲ್ಝಾರ
ਗੁਰੁਚਰਣ	ಗುರುಚರಣ
ਗੁਰੁਦਰ੍ਸ਼ਨ	ಗುರುದರ್ಸ಼ನ
ਗੁਰੁਦਾਸ	ಗುರುದಾಸ
ਗੁਰੁਦੀਪ	ಗುರುದೀಪ
ਗੁਰੁਪ੍ਰੇਮ	ಗುರುಪ್ರೇಮ
ਗੁਰੁਬੀਰ	ಗುರುಬೀರ
ਗੁਰੁਮਾਂਨ੍ਦੀਰ	ಗುರುಮಾಂನ್ದೀರ
ਗੁਰੁਸੀਮ੍ਰਣ	ಗುರುಸೀಮ್ರಣ
ਗੁਰ੍ਕੀਰਣ	ಗುರ್ಕೀರಣ
ਗੁਰ੍ਕੀਰਪਾਲ	ಗುರ್ಕೀರಪಾಲ
ਗੁਰ੍ਚਾਰਾਨ੍ਜੋਤ	ಗುರ್ಚಾರಾನ್ಜೋತ
ਗੁਰ੍ਜਨਪਾਲ	ಗುರ್ಜನಪಾಲ
ਗੁਰ੍ਜੁ	ಗುರ್ಜು
ਗੁਰ੍ਤੇਜ	ಗುರ್ತೇಜ
ਗੁਰ੍ਨੀਵਾਝ	ಗುರ್ನೀವಾಝ
ਗੁਰ੍ਨੂਰ	ಗುರ್ನೂರ
ਗੁਰ੍ਪ੍ਰਿਤੀ	ಗುರ್ಪ್ರಿತೀ
ਗੁਰ੍ਮੀਤ	ಗುರ್ಮೀತ
ਗੁਰ੍ਮੀਨਦੇਰ	ಗುರ್ಮೀನದೇರ
ਗੁਰ੍ਮੁਖਨੀਹਲ	ಗುರ್ಮುಖನೀಹಲ
ਗੁਰ੍ਸ਼ਣ	ಗುರ್ಸ಼ಣ
ਗੁਰ੍ਸ਼ਾਂਤ	ಗುರ್ಸ಼ಾಂತ
ਗੁਰ੍ਸ਼ੀਲ	ಗುರ್ಸ಼ೀಲ
ਗੁਰ੍ਸਾਹੇਬ	ಗುರ್ಸಾಹೇಬ
ਗੁਲਦੀਪ	ಗುಲದೀಪ
ਗੁਲਵਂਤ	ಗುಲವಂತ
ਗੁਲਸ਼ਾਨ੍ਰੂਪ	ಗುಲಸ಼ಾನ್ರೂಪ
ਗੁਲ੍ਵਾਨ੍ਤਪ੍ਰਿਤ	ಗುಲ್ವಾನ್ತಪ್ರಿತ
ਗੁਲ੍ਸ਼ਾਨਪ੍ਰਿਤ	ಗುಲ್ಸ಼ಾನಪ್ರಿತ
ਗੁਲ੍ਸ਼ਾਨਮਿਤ	ಗುಲ್ಸ಼ಾನಮಿತ
ਗੋਪਲਪ੍ਰਿਤ	ಗೋಪಲಪ್ರಿತ
ਗੋਬਿਂਦ	ಗೋಬಿಂದ
ਗੋਬੀਨਦੇਰ	ಗೋಬೀನದೇರ
ਗੋਬੀਨਦੇਰ੍ਜਿਤ	ಗೋಬೀನದೇರ್ಜಿತ
ਗੋਬੀਨ੍ਦਰਾਈ	ಗೋಬೀನ್ದರಾಈ
ਗੌਰਵ੍ਪ੍ਰਿਤ	ಗೌರವ್ಪ್ರಿತ
ਘਮਾਂਨਦ੍ਜਿਤ	ಘಮಾಂನದ್ಜಿತ
ਘਮਾਂਨਦ੍ਪਾਲ	ಘಮಾಂನದ್ಪಾಲ
ਚਂਚਲਜਿਤ	ಚಂಚಲಜಿತ
ਚਂਚਲ੍ਪ੍ਰੀਤ	ಚಂಚಲ್ಪ್ರೀತ
ਚਂਦਨ	ಚಂದನ
ਚਂਦਨਦੀਪ	ಚಂದನದೀಪ
ਚਮਕੌਰ	ಚಮಕೌರ
ਚਮਨਜਿਤ	ಚಮನಜಿತ
ਚਮਨਪ੍ਰਿਤ	ಚಮನಪ್ರಿತ
ਚਮਨਰੂਪ	ಚಮನರೂಪ
ਚਰਨਕਾਨ੍ਵਾਲ	ಚರನಕಾನ್ವಾಲ
ਚਰਨਜੋਤ /ਚਰਨਜ੍ਯੋਤ	ಚರನಜೋತ /ಚರನಜ್ಯೋತ
ਚਰਨਪ੍ਰੇਮ	ಚರನಪ್ರೇಮ
ਚਾਂਦ	ಚಾಂದ
ਚਿਤਰਾਮਣ	ಚಿತರಾಮಣ
ਚਿਤਸਰੂਪ	ಚಿತಸರೂಪ
ਚੀਤਪ੍ਰਿਤ	ಚೀತಪ್ರಿತ
ਚੇਤਨ੍ਦੀਪ	ಚೇತನ್ದೀಪ
ਜਗਜੀਤ	ಜಗಜೀತ
ਜਗਜੀਵ	ಜಗಜೀವ
ਜਗਜੀਵਨ	ಜಗಜೀವನ
ਜਗਤਜੀਤ	ಜಗತಜೀತ
ਜਗਤਪ੍ਰੇਮ	ಜಗತಪ್ರೇಮ
ਜਗਤਰਣ	ಜಗತರಣ
ਜਗਤਰੂਪ	ಜಗತರೂಪ
ਜਗਨ	ಜಗನ
ਜਗਪਾਲ	ಜಗಪಾಲ
ਜਗਪ੍ਰਿਤ	ಜಗಪ್ರಿತ
ਜਗਪ੍ਰੇਮ	ಜಗಪ್ರೇಮ
ਜਗਮਿਤ	ಜಗಮಿತ
ਜਗਮੇਹਾਰ	ಜಗಮೇಹಾರ
ਜਗਮੋਹਨ	ಜಗಮೋಹನ
ਜਗਰਾਜ	ಜಗರಾಜ
ਜਗਰੂਪ	ಜಗರೂಪ
ਜਗਵੀਨ੍ਦੇਰ	ಜಗವೀನ್ದೇರ
ਜਗਵੀਰ	ಜಗವೀರ
ਜਗੀਨਦੇਰ	ಜಗೀನದೇರ
ਜਗੀਨ੍ਦੇਰਪਾਲ	ಜಗೀನ್ದೇರಪಾಲ
ਜਗ੍ਵੀਰ	ಜಗ್ವೀರ
ਜਘ੍ਰ	ಜಘ್ರ
ਜਤੀਨਦੇਰ੍ਜਿਤ	ಜತೀನದೇರ್ಜಿತ
ਜਤੀਨਦੇਰ੍ਬੀਰ	ಜತೀನದೇರ್ಬೀರ
ਜਤੀਨਦੇਰ੍ਮਿਤ	ಜತೀನದೇರ್ಮಿತ
ਜਨਜਿਤ	ಜನಜಿತ
ਜਨਜੋਤ	ಜನಜೋತ
ਜਨਪ੍ਰਿਤ	ಜನಪ್ರಿತ
ਜਨਰਾਜ	ಜನರಾಜ
ਜਨਿਸ਼	ಜನಿಸ಼
ਜਪਜਿਤ	ಜಪಜಿತ
ਜਪਧਾਰਾਮ	ಜಪಧಾರಾಮ
ਜਪਧਿਰ	ಜಪಧಿರ
ਜਪਨਾਮ	ಜಪನಾಮ
ਜਪਸ਼ੇਰ	ಜಪಸ಼ೇರ
ਜਪੁਜੀ	ಜಪುಜೀ
ਜਬਰਜਂਗ	ಜಬರಜಂಗ
ਜਮੀਲ	ಜಮೀಲ
ਜਯਂਸ਼	ಜಯಂಸ಼
ਜਯਪਾਲ	ಜಯಪಾಲ
ਜਰ੍ਨੈਲ	ಜರ್ನೈಲ
ਜਲਿਨ੍ਦ੍ਰ	ಜಲಿನ್ದ್ರ
ਜਲ੍ਬੀਰ	ಜಲ್ಬೀರ
ਜਸਂਜੋਤ	ಜಸಂಜೋತ
ਜਸਂਪਾਲ	ಜಸಂಪಾಲ
ਜਸਂਮਿਤ	ಜಸಂಮಿತ
ਜਸਕੀਰਣ	ಜಸಕೀರಣ
ਜਸਗੁਰ੍ਕੀਰ੍ਤਤ	ಜಸಗುರ್ಕೀರ್ತತ
ਜਸਜੀਨ੍ਦੇਰ	ಜಸಜೀನ್ದೇರ
ਜਸਜੀਵਨ	ಜಸಜೀವನ
ਜਸਜੋਤ	ಜಸಜೋತ
ਜਸਤਰਣ	ಜಸತರಣ
ਜਸਨਾਮ	ಜಸನಾಮ
ਜਸਪਾਲ (ਪੁਲ )	ಜಸಪಾಲ (ಪುಲ )
ਜਸਬੀਰ	ಜಸಬೀರ
ਜਸਭੂਪ	ಜಸಭೂಪ
ਜਸਮਿਂਦਰ	ಜಸಮಿಂದರ
ਜਸਮੋਹਨ	ಜಸಮೋಹನ
ਜਸਰੂਪ	ಜಸರೂಪ
ਜਸ੍ਕਰਣ	ಜಸ್ಕರಣ
ਜਸ੍ਕੀਰਿਤ	ಜಸ್ಕೀರಿತ
ਜਸ੍ਕੀਰ੍ਪਲ	ಜಸ್ಕೀರ್ಪಲ
ਜਸ੍ਗੁਨ	ಜಸ್ಗುನ
ਜਸ੍ਮਿਤ	ಜಸ್ಮಿತ
ਜਸ੍ਮੀਨਪ੍ਰਿਤ	ಜಸ್ಮೀನಪ್ರಿತ
ਜਸ੍ਰਜਪ੍ਰਿਤ	ಜಸ್ರಜಪ್ರಿತ
ਜਸ੍ਸੀ	ಜಸ್ಸೀ
ਜਾਗ	ಜಾಗ
ਜਾਗਰੀਤ	ಜಾಗರೀತ
ਜਾਤਵਂਤ	ಜಾತವಂತ
ਜਾਤਿਨਦੇਰ੍ਦੀਪ	ಜಾತಿನದೇರ್ದೀಪ
ਜਾਨਾਕਪ੍ਰਿਤ	ಜಾನಾಕಪ್ರಿತ
ਜਾਪਮਾਨ	ಜಾಪಮಾನ
ਜਾਸਨਿਤ	ಜಾಸನಿತ
ਜਾਸ਼ਾਨਪ੍ਰਿਤ	ಜಾಸ಼ಾನಪ್ರಿತ
ਜਾਸ੍ਮੀਲ	ಜಾಸ್ಮೀಲ
ਜੀਵਨਦੀਪ ; ਜੀਵਨਦੀਪ ; ਜੀਵਨਦੀਪ	ಜೀವನದೀಪ ; ಜೀವನದೀಪ ; ಜೀವನದೀಪ
ਜੀਵਨਪਲ	ಜೀವನಪಲ
ਜੀਵਨਪ੍ਰਿਤ	ಜೀವನಪ್ರಿತ
ਜੀਵਾਨਬੀਰ	ಜೀವಾನಬೀರ
ਜੁਗਦ	ಜುಗದ
ਜੁਪੀਨਦੇਰਦੀਪ	ಜುಪೀನದೇರದೀಪ
ਜੁਪੀਨਦੇਰ੍ਬੀਰ	ಜುಪೀನದೇರ್ಬೀರ
ਜੁਸਜਿਤ	ಜುಸಜಿತ
ਜੁਸਪੁਲ	ಜುಸಪುಲ
ਜੁਸਮੈਲ	ಜುಸಮೈಲ
ਜੇਬਾ	ಜೇಬಾ
ਜੇਸਪਾਲ	ಜೇಸಪಾಲ
ਜੈਕਾਰ	ಜೈಕಾರ
ਜੈਪ੍ਰਜ	ಜೈಪ್ರಜ
ਜੈਪ੍ਰਤਨ	ಜೈಪ್ರತನ
ਜੈਬੀਰ	ಜೈಬೀರ
ਜੈਸਂਗਤ	ಜೈಸಂಗತ
ਜੈਸੁਖਬੀਰ	ಜೈಸುಖಬೀರ
ਜੋਗਧੀਆਨ	ಜೋಗಧೀಆನ
ਜੋਗਪ੍ਰਕਾਸ਼	ಜೋಗಪ್ರಕಾಸ಼
ਜੋਗੀਨਦੇਰ੍ਬੀਰ	ಜೋಗೀನದೇರ್ಬೀರ
ਜੋਗੀਨਦੇਰ੍ਮਿਤ	ಜೋಗೀನದೇರ್ಮಿತ
ਜੋਗੇਨਦੇਰ	ಜೋಗೇನದೇರ
ਜੋਤਪ੍ਰਕਾਸ਼	ಜೋತಪ್ರಕಾಸ಼
ਜੋਬਨਰੂਪ	ಜೋಬನರೂಪ
ਜੋਹਾਰ	ಜೋಹಾರ
ਜ੍ਞਾਨਜਿਤ	ಜ್ಞಾನಜಿತ
ਜ੍ਞਾਨਜੋਤ	ಜ್ಞಾನಜೋತ
ਜ੍ਞਾਨਪ੍ਰਿਤ	ಜ್ಞಾನಪ್ರಿತ
ਜ੍ਞਾਨਰੂਪ	ಜ್ಞಾನರೂಪ
ਜ੍ਞਾਨਵੀਰ	ಜ್ಞಾನವೀರ
ਜ੍ਞਾਨੇਨ੍ਦੇਰ	ಜ್ಞಾನೇನ್ದೇರ
ਜ੍ਹਮਕ	ಜ್ಹಮಕ
ਜ੍ਹਾਗਰ	ಜ್ಹಾಗರ
ਝਈਤੂਨ	ಝಈತೂನ
ਝਹਾਗਨ	ಝಹಾಗನ
ਝਾਮੀਨਾਹ	ಝಾಮೀನಾಹ
ਝੀਤੁਨ	ಝೀತುನ
ਝੀਲ	ಝೀಲ
ਝੁਲਾਖਾ	ಝುಲಾಖಾ
ਝੁਲ੍ਫਾ	ಝುಲ್ಫಾ
ਝੇਬਵਂਤ	ಝೇಬವಂತ
ਝੋਰਾਵਾਰ	ಝೋರಾವಾರ
ਟੇਇਜਿਨ੍ਦੇਰ	ಟೇಇಜಿನ್ದೇರ
ਤਕਦੀਰ	ತಕದೀರ
ਤਖਤ	ತಖತ
ਤਤਜੋਗ	ತತಜೋಗ
ਤਤਬੀਰ	ತತಬೀರ
ਤਤਵਿਚਾਰ	ತತವಿಚಾರ
ਤਤ੍ਰਾਤਨ	ತತ್ರಾತನ
ਤਦਬੀਰ	ತದಬೀರ
ਤਨਦੀਪ	ತನದೀಪ
ਤਨਵੀਰ	ತನವೀರ
ਤਮਨ੍ਪ੍ਰਿਤ	ತಮನ್ಪ್ರಿತ
ਤਰਣਵੀਰ	ತರಣವೀರ
ਤਰਲੋਚਨ	ತರಲೋಚನ
ਤਰਸੇਮ	ತರಸೇಮ
ਤਰੁਨਜਿਤ	ತರುನಜಿತ
ਤਲਵਿਨ	ತಲವಿನ
ਤਾਜਦਾਰ	ತಾಜದಾರ
ਤਾਜੀਨਦੇਰ੍ਦੀਪ	ತಾಜೀನದೇರ್ದೀಪ
ਤਾਜੀਨਦੇਰ੍ਪ੍ਰੇਮ	ತಾಜೀನದೇರ್ಪ್ರೇಮ
ਤਾਨੁਪ੍ਰਿਤ	ತಾನುಪ್ರಿತ
ਤਾਪਨਪਾਲ	ತಾಪನಪಾಲ
ਤੀਰਨ /ਤਿਹ੍ਰਣ /ਤੇਯ੍ਰੁਣ	ತೀರನ /ತಿಹ್ರಣ /ತೇಯ್ರುಣ
ਤੀਰਾਥ੍ਰਾਮ	ತೀರಾಥ್ರಾಮ
ਤੁਵਿਜਾਤ	ತುವಿಜಾತ
ਤੇਕਜੀਤ	ತೇಕಜೀತ
ਤੇਕਦੀਪ	ತೇಕದೀಪ
ਤੇਕਪ੍ਰਿਤ	ತೇಕಪ್ರಿತ
ਤੇਕ੍ਪਾਲ	ತೇಕ್ಪಾಲ
ਤੇਘਬਹਾਦੁਰ	ತೇಘಬಹಾದುರ
ਤੇਜਧਾਰਾਮ	ತೇಜಧಾರಾಮ
ਤੇਜਨਾਮ	ತೇಜನಾಮ
ਤੇਜਪ੍ਰਤਾਪ	ತೇಜಪ್ರತಾಪ
ਤੇਜ਼	ತೇಜ಼
ਤੇਜਾਸਵੀਰ	ತೇಜಾಸವೀರ
ਤੇਜੀਨਦੇਰ੍ਜੀਤ	ತೇಜೀನದೇರ್ಜೀತ
ਤੇਜੀਨਦੇਰ੍ਪਾਲ	ತೇಜೀನದೇರ್ಪಾಲ
ਤੋਤਾਸਿਂਹ	ತೋತಾಸಿಂಹ
ਤ੍ਰਿਪਲ	ತ್ರಿಪಲ
ਤ੍ਰਿਲੋਚਨ	ತ್ರಿಲೋಚನ
ਤ੍ਰੀਭਾਵਾਨ	ತ್ರೀಭಾವಾನ
ਤ੍ਰੀਸ਼ਾਨਜੋਤ	ತ್ರೀಸ಼ಾನಜೋತ
ਤ੍ਰੀਸ਼ਾਨਦੀਪ	ತ್ರೀಸ಼ಾನದೀಪ
ਤ੍ਰੀਸ਼ਾਨਬੀਰ	ತ್ರೀಸ಼ಾನಬೀರ
ਥਾਕੁਰਨਾਮ	ಥಾಕುರನಾಮ
ਥਾਲਭੂਪ	ಥಾಲಭೂಪ
ਥਾਲਰਾਜ	ಥಾಲರಾಜ
ਥੀਰਮਾਨ	ಥೀರಮಾನ
ਥੀਰ੍ਧੀਆਨ	ಥೀರ್ಧೀಆನ
ਦਮਨਜਿਤ	ದಮನಜಿತ
ਦਮਨਜੋਤ	ದಮನಜೋತ
ਦਯਾਜੋਤ	ದಯಾಜೋತ
ਦਯਾਦੀਪ	ದಯಾದೀಪ
ਦਰਮੀਨ੍ਦੇਰ	ದರಮೀನ್ದೇರ
ਦਰ੍ਪ੍ਰਿਤ	ದರ್ಪ್ರಿತ
ਦਲਜੋਧ	ದಲಜೋಧ
ਦਲਬੀਨਦੇਰ	ದಲಬೀನದೇರ
ਦਲਬੀਨ੍ਦੇਰ੍ਜਿਤ	ದಲಬೀನ್ದೇರ್ಜಿತ
ਦਲਰਾਜ	ದಲರಾಜ
ਦਲੇਰ	ದಲೇರ
ਦਵੀਨ੍ਦੇਰ	ದವೀನ್ದೇರ
ਦਿਦਾਰ	ದಿದಾರ
ਦਿਨਤੇਕ	ದಿನತೇಕ
ਦਿਪਲੀਨ	ದಿಪಲೀನ
ਦਿਲਜੋਤ	ದಿಲಜೋತ
ਦਿਲਨਿਤ	ದಿಲನಿತ
ਦਿਲਪ੍ਰਿਤ	ದಿಲಪ್ರಿತ
ਦਿਲਮਿਤ	ದಿಲಮಿತ
ਦਿਲਰਿਤ	ದಿಲರಿತ
ਦਿਲਸ਼ਾਨ	ದಿಲಸ಼ಾನ
ਦਿਲਸ਼ੇਰ	ದಿಲಸ಼ೇರ
ਦਿਵ੍ਯਜ੍ਯੋਤ	ದಿವ್ಯಜ್ಯೋತ
ਦੀਲਜੀਤ	ದೀಲಜೀತ
ਦੀਲਬਾਘ	ದೀಲಬಾಘ
ਦੀਲ੍ਜਿਤ	ದೀಲ್ಜಿತ
ਦੀਵ੍ਯਜੋਤ	ದೀವ್ಯಜೋತ
ਦੇਵਜੀਤ	ದೇವಜೀತ
ਦੇਵਪ੍ਰਿਤ	ದೇವಪ್ರಿತ
ਦੇਵਾਤ੍ਮਾ	ದೇವಾತ್ಮಾ
ਦੇਵੀਨ੍ਦੇਰ	ದೇವೀನ್ದೇರ
ਧਰਮਜ੍ਯੋਤ	ಧರಮಜ್ಯೋತ
ਧਰਮਪਾਲ	ಧರಮಪಾಲ
ਧਰਮਪ੍ਰੀਤ	ಧರಮಪ್ರೀತ
ਧਰਮਲੀਨ	ಧರಮಲೀನ
ਧੀਅਨ੍ਜੋਗ	ಧೀಅನ್ಜೋಗ
ਨਕ੍ਸ਼ਤ੍ਰਾ	ನಕ್ಸ಼ತ್ರಾ
ਨਮ੍ਰੀਤਾਬੀਰ	ನಮ್ರೀತಾಬೀರ
ਨਯਨਦੀਪ	ನಯನದೀಪ
ਨਰਿਨ੍ਦਰ	ನರಿನ್ದರ
ਨਰੇਨ੍ਦ੍ਰ	ನರೇನ್ದ್ರ
ਨਵਜੀਤ	ನವಜೀತ
ਨਵਜੀਵਨ	ನವಜೀವನ
ਨਵਦੀਪ	ನವದೀಪ
ਨਵਬੀਰ	ನವಬೀರ
ਨਵਮਿਤ	ನವಮಿತ
ਨਵ੍ਜੀਨ੍ਦੇਰ	ನವ್ಜೀನ್ದೇರ
ਨਾਗਂਦਰ	ನಾಗಂದರ
ਨਾਨਕੀ	ನಾನಕೀ
ਨਾਨਵੀਰ	ನಾನವೀರ
ਨਾਨ੍ਦਾਨਜਿਤ	ನಾನ್ದಾನಜಿತ
ਨਾਨ੍ਦਾਨਪ੍ਰਿਤ	ನಾನ್ದಾನಪ್ರಿತ
ਨਾਮਜੀਵ	ನಾಮಜೀವ
ਨਾਮਜੋਗ	ನಾಮಜೋಗ
ਨਾਮਜੋਤ	ನಾಮಜೋತ
ਨਾਮਜੋਧ	ನಾಮಜೋಧ
ਨਾਮਧਾਰ	ನಾಮಧಾರ
ਨਾਮਧਿਯਨ	ನಾಮಧಿಯನ
ਨਾਮਧਿਰ	ನಾಮಧಿರ
ਨਾਮਨੀਰ੍ਮਾਲ	ನಾಮನೀರ್ಮಾಲ
ਨਾਮਨੀਵਾਸ	ನಾಮನೀವಾಸ
ਨਾਮਪ੍ਰਿਤ	ನಾಮಪ್ರಿತ
ਨਾਮਪ੍ਰੇਮ	ನಾಮಪ್ರೇಮ
ਨਾਮਭਾਗਤ	ನಾಮಭಾಗತ
ਨਾਮਵਿਚਾਰ	ನಾಮವಿಚಾರ
ਨਾਮਸ਼ਰਣ	ನಾಮಸ಼ರಣ
ਨਾਮਾਂਡੋਲ਼	ನಾಮಾಂಡೋಲ಼
ਨਾਮਾਹਾਰ	ನಾಮಾಹಾರ
ਨਾਮੁਤ੍ਤਮ	ನಾಮುತ್ತಮ
ਨਾਮ੍ਰਾਤਨ	ನಾಮ್ರಾತನ
ਨਾਮ੍ਰਿਤਾ	ನಾಮ್ರಿತಾ
ਨਾਮ੍ਰੀਤਾਜੋਤ	ನಾಮ್ರೀತಾಜೋತ
ਨਾਮ੍ਰੀਤਾਦੀਪ	ನಾಮ್ರೀತಾದೀಪ
ਨਾਮ੍ਰੀਤਾਪ੍ਰਿਤ	ನಾಮ್ರೀತಾಪ್ರಿತ
ਨਾਰ	ನಾರ
ਨਾਰਂਜਨ	ನಾರಂಜನ
ਨਾਰੀਤਪਲ	ನಾರೀತಪಲ
ਨਾਰੀਨਦੇਰਦੀਪ	ನಾರೀನದೇರದೀಪ
ਨਾਰੈਨ	ನಾರೈನ
ਨਾਵਿਨਜਿਤ	ನಾವಿನಜಿತ
ਨਾਵ੍ਕੀਰਣ	ನಾವ್ಕೀರಣ
ਨਾਵ੍ਕੀਰਨਜੋਤ	ನಾವ್ಕೀರನಜೋತ
ਨਾਵ੍ਪ੍ਰਿਤ	ನಾವ್ಪ್ರಿತ
ਨਿਮਾਈ	ನಿಮಾಈ
ਨਿਰਂਜਨ	ನಿರಂಜನ
ਨਿਰਂਜਨਾ	ನಿರಂಜನಾ
ਨਿਰ੍ਮਲਜੀਤ	ನಿರ್ಮಲಜೀತ
ਨਿਲਾਮਜੋਤ	ನಿಲಾಮಜೋತ
ਨਿਲਾਮਪੁਲ	ನಿಲಾಮಪುಲ
ਨਿਲਾਮਪ੍ਰਿਤ	ನಿಲಾಮಪ್ರಿತ
ਨਿਲਾਮਬੇਰ	ನಿಲಾಮಬೇರ
ਨਿਸ਼ਾ	ನಿಸ಼ಾ
ਨਿਹ੍ਚਾਲਤੇਕ	ನಿಹ್ಚಾಲತೇಕ
ਨਿਹ੍ਚਾਲਮਿਤ	ನಿಹ್ಚಾಲಮಿತ
ਨੀਤਨਾਮ	ನೀತನಾಮ
ਨੀਨਦੇਰ੍ਬੀਰ	ನೀನದೇರ್ಬೀರ
ਨੀਮਮਾਂਪ੍ਰਿਤ	ನೀಮಮಾಂಪ್ರಿತ
ਨੀਮਮਾਂਰ੍ਦੀਪ	ನೀಮಮಾಂರ್ದೀಪ
ਨੀਮ੍ਮਾਂਰਤਾ	ನೀಮ್ಮಾಂರತಾ
ਨੀਮ੍ਰਤ	ನೀಮ್ರತ
ਨੀਰਮਾਂਲਦੀਪ	ನೀರಮಾಂಲದೀಪ
ਨੀਰਮਾਂਲਬੀਰ	ನೀರಮಾಂಲಬೀರ
ਨੀਰਮੋਲ	ನೀರಮೋಲ
ਨੀਰਵੈਰ	ನೀರವೈರ
ਨੀਰ੍ਭਾਉ	ನೀರ್ಭಾಉ
ਨੀਰ੍ਮਾਂਲਕਾਰਾਮ	ನೀರ್ಮಾಂಲಕಾರಾಮ
ਨੀਰ੍ਮਾਂਲਜੀਵ	ನೀರ್ಮಾಂಲಜೀವ
ਨੀਰ੍ਮਾਂਲਜੋਤ	ನೀರ್ಮಾಂಲಜೋತ
ਨੀਰ੍ਮਾਂਲਤੇਕ	ನೀರ್ಮಾಂಲತೇಕ
ਨੀਰ੍ਮਾਂਲਧਾਰਾਮ	ನೀರ್ಮಾಂಲಧಾರಾಮ
ਨੀਰ੍ਮਾਂਲਪ੍ਰਿਤ	ನೀರ್ಮಾಂಲಪ್ರಿತ
ਨੀਸ਼ਾਨ੍ਦੀਪ	ನೀಸ಼ಾನ್ದೀಪ
ਨੀਹ੍ਚਾਲ੍ਪ੍ਰੇਮ	ನೀಹ್ಚಾಲ್ಪ್ರೇಮ
ਨੂਰਦੇਵ	ನೂರದೇವ
ਨੂਰਨਿਤ	ನೂರನಿತ
ਨੂਰਪ੍ਰਿਤ	ನೂರಪ್ರಿತ
ਨੇਕਨਾਮ	ನೇಕನಾಮ
ਨੇਕੀਨਦੇਰ	ನೇಕೀನದೇರ
ਨੇਕ੍ਦੀਪ	ನೇಕ್ದೀಪ
ਨੇਕ੍ਪਾਲ	ನೇಕ್ಪಾಲ
ਨੇਹ੍ਚਾਲਪ੍ਰਿਤ	ನೇಹ್ಚಾಲಪ್ರಿತ
ਨੈਨਤਾਰ	ನೈನತಾರ
ਨੈਨਦੀਪ	ನೈನದೀಪ
ਨੈਨੀਨਦੇਰ	ನೈನೀನದೇರ
ਨੋਉਲਖ	ನೋಉಲಖ
ਨੌਹਨੀਹਲ	ನೌಹನೀಹಲ
ਨ੍ਰੀਪਜੋਤ	ನ್ರೀಪಜೋತ
ਪਤਵਂਤ	ಪತವಂತ
ਪਤਵੀਰ	ಪತವೀರ
ਪਦਾਮਜਿਤ	ಪದಾಮಜಿತ
ਪਦਾਮਪ੍ਰੇਮ	ಪದಾಮಪ್ರೇಮ
ਪਦ੍ਮਸ਼੍ਰੀ	ಪದ್ಮಸ಼್ರೀ
ਪਰਤਾਪ ; ਪਰਤਾਪ	ಪರತಾಪ ; ಪರತಾಪ
ਪਰਤਾਪੀ	ಪರತಾಪೀ
ਪਰਦੀਪ	ಪರದೀಪ
ਪਰਬੀਨ	ಪರಬೀನ
ਪਰਮਕਮਲ਼	ಪರಮಕಮಲ಼
ਪਰਮਕਿਰਤ	ಪರಮಕಿರತ
ਪਰਮਗੁਨ	ಪರಮಗುನ
ਪਰਮਜਾਪ	ಪರಮಜಾಪ
ਪਰਮਜੀਤ ; ਪਰਮਜੀਤ	ಪರಮಜೀತ ; ಪರಮಜೀತ
ਪਰਮਜੁਗਤ	ಪರಮಜುಗತ
ਪਰਮਜੋਗ	ಪರಮಜೋಗ
ਪਰਮਜੋਧ	ಪರಮಜೋಧ
ਪਰਮਠਾਕਰ	ಪರಮಠಾಕರ
ਪਰਮਤੇਕ	ಪರಮತೇಕ
ਪਰਮਦੀਪ	ಪರಮದೀಪ
ਪਰਮਧਾਰਾਮ	ಪರಮಧಾರಾಮ
ਪਰਮਧਿਰ	ಪರಮಧಿರ
ਪਰਮਪਾਲ	ಪರಮಪಾಲ
ਪਰਮਪ੍ਰੇਮ	ಪರಮಪ್ರೇಮ
ਪਰਮਬੋਧ	ಪರಮಬೋಧ
ਪਰਮਯੋਗ	ಪರಮಯೋಗ
ਪਰਮਰਂਗ	ಪರಮರಂಗ
ਪਰਮਲੀਨ	ಪರಮಲೀನ
ਪਰਮਸ਼ਾਂਤ	ಪರಮಸ಼ಾಂತ
ਪਰਮਸਿਤਾਲ	ಪರಮಸಿತಾಲ
ਪਰਮਸੁਖ	ಪರಮಸುಖ
ਪਰਮਸੇਵਕ	ಪರಮಸೇವಕ
ਪਰਮਾਧਾਰ	ಪರಮಾಧಾರ
ਪਰਮਾਰ੍ਥ	ಪರಮಾರ್ಥ
ਪਰਮਿਂਦਰ	ಪರಮಿಂದರ
ਪਰਮੀਤ	ಪರಮೀತ
ਪਰਮ੍ਦਯਾ	ಪರಮ್ದಯಾ
ਪਰਸਂਜੀਤ	ಪರಸಂಜೀತ
ਪਰਸ਼ੋਤਮ	ಪರಸ಼ೋತಮ
ਪਰਾਮਨੀਵਾਸ	ಪರಾಮನೀವಾಸ
ਪਰੀਦਰ੍ਸ਼ਨ	ಪರೀದರ್ಸ಼ನ
ਪਰ੍ਗਤ	ಪರ್ಗತ
ਪਰ੍ਵੀਨ੍ਦੇਰ	ಪರ್ವೀನ್ದೇರ
ਪਲਬੀਨਦੇਰ	ಪಲಬೀನದೇರ
ਪਲਵੀਨ੍ਦੇਰ੍ਪਾਲ	ಪಲವೀನ್ದೇರ್ಪಾಲ
ਪਵਾਨਜੋਤ	ಪವಾನಜೋತ
ਪਵਾਨਦੀਪ	ಪವಾನದೀಪ
ਪਵਾਨਪ੍ਰਿਤ	ಪವಾನಪ್ರಿತ
ਪਵਾਨਵੀਰ	ಪವಾನವೀರ
ਪਵੀਤ	ಪವೀತ
ਪਾਰਂਗਤ	ಪಾರಂಗತ
ਪੁਨੀਤ	ಪುನೀತ
ਪੁਨੀਤਪਾਲ	ಪುನೀತಪಾಲ
ਪੁਰਾਨਪ੍ਰੇਮ	ಪುರಾನಪ್ರೇಮ
ਪੁਰਾਨ੍ਜੀਤ	ಪುರಾನ್ಜೀತ
ਪੁਸ਼ਪ੍ਰਿਤ	ಪುಸ಼ಪ್ರಿತ
ਪੁਸ਼੍ਪਿਤਾ	ಪುಸ಼್ಪಿತಾ
ਪੂਰਨਜੀਤ	ಪೂರನಜೀತ
ਪ੍ਰਗਿਤ	ಪ್ರಗಿತ
ਪ੍ਰਜਨਾ	ಪ್ರಜನಾ
ਪ੍ਰਣਿਤ	ಪ್ರಣಿತ
ਪ੍ਰਨੀਤਾ	ಪ್ರನೀತಾ
ਪ੍ਰਫੂਲਦੀਪ	ಪ್ರಫೂಲದೀಪ
ਪ੍ਰਭਕੀਰਤ	ಪ್ರಭಕೀರತ
ਪ੍ਰਭਕੀਰ੍ਪਾਲ	ಪ್ರಭಕೀರ್ಪಾಲ
ਪ੍ਰਭਗੀਤ	ಪ್ರಭಗೀತ
ਪ੍ਰਭਚਰਣ	ಪ್ರಭಚರಣ
ਪ੍ਰਭਚੇਤਨ	ಪ್ರಭಚೇತನ
ਪ੍ਰਭਜਿਤ	ಪ್ರಭಜಿತ
ਪ੍ਰਭਜੀਤ	ಪ್ರಭಜೀತ
ਪ੍ਰਭਜੀਵਨ	ಪ್ರಭಜೀವನ
ਪ੍ਰਭਜੋਗ	ಪ್ರಭಜೋಗ
ਪ੍ਰਭਜੋਤੇ	ಪ್ರಭಜೋತೇ
ਪ੍ਰਭਜੋਧ	ಪ್ರಭಜೋಧ
ਪ੍ਰਭਤਿਰਥ	ಪ್ರಭತಿರಥ
ਪ੍ਰਭਦਾਸ	ಪ್ರಭದಾಸ
ਪ੍ਰਭਧਿਯਨ	ಪ್ರಭಧಿಯನ
ਪ੍ਰਭਧਿਰਾਜ	ಪ್ರಭಧಿರಾಜ
ਪ੍ਰਭਨਾਮ	ಪ್ರಭನಾಮ
ਪ੍ਰਭਨੂਰ	ಪ್ರಭನೂರ
ਪ੍ਰਭਪਰ੍ਵਾਨ	ಪ್ರಭಪರ್ವಾನ
ਪ੍ਰਭਬੋਧ	ಪ್ರಭಬೋಧ
ਪ੍ਰਭਮਿਤ	ಪ್ರಭಮಿತ
ਪ੍ਰਭਮੇਹਾਰ	ಪ್ರಭಮೇಹಾರ
ਪ੍ਰਭਲੀਨ	ಪ್ರಭಲೀನ
ਪ੍ਰਭਵਿਚਾਰ	ಪ್ರಭವಿಚಾರ
ਪ੍ਰਭਸਂਗਤ	ಪ್ರಭಸಂಗತ
ਪ੍ਰਭਸਿਤਾਲ	ಪ್ರಭಸಿತಾಲ
ਪ੍ਰਭਾਤਕੀਰਣ	ಪ್ರಭಾತಕೀರಣ
ਪ੍ਰਭ੍ਰਮਣ	ಪ್ರಭ್ರಮಣ
ਪ੍ਰਭ੍ਰਾਤਨ	ಪ್ರಭ್ರಾತನ
ਪ੍ਰਭ੍ਰੂਪ	ಪ್ರಭ್ರೂಪ
ਪ੍ਰਸ਼ਾਰਨਬੀਰ	ಪ್ರಸ಼ಾರನಬೀರ
ਪ੍ਰਿਤਮੋਹਨ	ಪ್ರಿತಮೋಹನ
ਪ੍ਰਿਤੀਨ੍ਦੇਰ	ಪ್ರಿತೀನ್ದೇರ
ਪ੍ਰਿਤ੍ਵੀਰ	ಪ್ರಿತ್ವೀರ
ਪ੍ਰੀਤਪਾਲ	ಪ್ರೀತಪಾಲ
ਪ੍ਰੀਤਮ੍ਹਾਰੀ	ಪ್ರೀತಮ್ಹಾರೀ
ਪ੍ਰੀਤਾਮਜਿਤ	ಪ್ರೀತಾಮಜಿತ
ਪ੍ਰੀਥਾਮ੍ਦੀਪ	ಪ್ರೀಥಾಮ್ದೀಪ
ਪ੍ਰੀਥੀਪਾਲ	ಪ್ರೀಥೀಪಾಲ
ਪ੍ਰੀਥ੍ਵੀਪਾਲ	ಪ್ರೀಥ್ವೀಪಾಲ
ਪ੍ਰੇਮਜਿਤ	ಪ್ರೇಮಜಿತ
ਪ੍ਰੇਮਤੇਕ	ಪ್ರೇಮತೇಕ
ਪ੍ਰੇਮਪਾਲ	ಪ್ರೇಮಪಾಲ
ਪ੍ਰੇਮਬਂਸ	ಪ್ರೇಮಬಂಸ
ਪ੍ਰੇਮਭਾਗਤ	ಪ್ರೇಮಭಾಗತ
ਪ੍ਰੇਮਰਂਗ	ಪ್ರೇಮರಂಗ
ਪ੍ਰੇਮਰਮਣ	ಪ್ರೇಮರಮಣ
ਪ੍ਰੇਮਰਸ	ಪ್ರೇಮರಸ
ਪ੍ਰੇਮਲੀਨ	ಪ್ರೇಮಲೀನ
ਪ੍ਰੇਮਵਾਂਤ	ಪ್ರೇಮವಾಂತ
ਪ੍ਰੇਮਸੀਰੀ	ಪ್ರೇಮಸೀರೀ
ਪ੍ਰੇਮਸੁਖ	ಪ್ರೇಮಸುಖ
ਪ੍ਰੇਮ੍ਵੀਰ	ಪ್ರೇಮ್ವೀರ
ਫਕੀਰ	ಫಕೀರ
ਫਤੇਹਕਾਰਾਮ	ಫತೇಹಕಾರಾಮ
ਫਤੇਹਪ੍ਰਿਤ	ಫತೇಹಪ್ರಿತ
ਫਤੇਹਬੀਰ	ಫತೇಹಬೀರ
ਫਤੇਹ੍ਵਂਤ	ಫತೇಹ್ವಂತ
ਫਾਜਲ	ಫಾಜಲ
ਫੁਲਵਂਤ	ಫುಲವಂತ
ਫੋਜੀਨਦੇਰ	ಫೋಜೀನದೇರ
ਬਂਸਮਿਤ	ಬಂಸಮಿತ
ਬਕ੍ਸ਼ੀ	ಬಕ್ಸ಼ೀ
ਬਚਾਨਬੀਰ	ಬಚಾನಬೀರ
ਬਚੀਨ੍ਤ	ಬಚೀನ್ತ
ਬਨੀਤ	ಬನೀತ
ਬਨੀਨਦੇਰ	ಬನೀನದೇರ
ਬਰਿਨ੍ਦ੍ਰ	ಬರಿನ್ದ್ರ
ਬਰੀਨ੍ਦੇਰ	ಬರೀನ್ದೇರ
ਬਲਤੇਜ	ಬಲತೇಜ
ਬਲਦੀਪ	ಬಲದೀಪ
ਬਲਦੇਵ	ಬಲದೇವ
ਬਲਮੋਹਨ	ಬಲಮೋಹನ
ਬਲਰਾਜ	ಬಲರಾಜ
ਬਲਵਿਂਦਰ	ಬಲವಿಂದರ
ਬਲੀਨਦੇਰ	ಬಲೀನದೇರ
ਬਲੀਹਾਰ	ಬಲೀಹಾರ
ਬਲ੍ਵਿਨ੍ਦ੍ਰ	ಬಲ್ವಿನ್ದ್ರ
ਬਲ੍ਵੀਨ੍ਦੇਰ	ಬಲ್ವೀನ್ದೇರ
ਬਹਾਦਰ	ಬಹಾದರ
ਬਾਲਮਿਤ	ಬಾಲಮಿತ
ਬਿਸ਼ਨਪਾਲ	ಬಿಸ಼ನಪಾಲ
ਬਿਸ੍ਮੀਤ	ಬಿಸ್ಮೀತ
ਬੀਨਦੇਰ	ಬೀನದೇರ
ਬੀਨਾ	ಬೀನಾ
ਬੀਬੀਨਾਨਾਕੀ	ಬೀಬೀನಾನಾಕೀ
ਬੀਮਾਂਲਜੋਤ	ಬೀಮಾಂಲಜೋತ
ਬੀਰੀਨਦਾਰ	ಬೀರೀನದಾರ
ਬੀਸਮਾਧ	ಬೀಸಮಾಧ
ਬੀਸ਼੍ਮਿਤ	ಬೀಸ಼್ಮಿತ
ਬੁਜੀ	ಬುಜೀ
ਬੁਧ੍ਪ੍ਰਿਤ	ಬುಧ್ಪ್ರಿತ
ਬੁਧ੍ਰੂਪ	ಬುಧ್ರೂಪ
ਬੇਂਤ	ಬೇಂತ
ਬੇਨ੍ਨੀ	ಬೇನ್ನೀ
ਬੇਬੇ	ಬೇಬೇ
ਬੈਰਾਗੀ	ಬೈರಾಗೀ
ਬ੍ਰਹਮਜੋਤ	ಬ್ರಹಮಜೋತ
ਬ੍ਰਹਾਮਲੀਨ	ಬ್ರಹಾಮಲೀನ
ਬ੍ਰਹਾਮ੍ਜੀਤ	ಬ್ರಹಾಮ್ಜೀತ
ਬ੍ਰਹ੍ਮਲੀਨ	ಬ್ರಹ್ಮಲೀನ
ਬ੍ਰਹ੍ਮਵੀਰ	ಬ್ರಹ್ಮವೀರ
ਬ੍ਰਿਜੇਂਦਰ	ಬ್ರಿಜೇಂದರ
ਬ੍ਰੀਜੋਧ	ಬ್ರೀಜೋಧ
ਭਗਤ	ಭಗತ
ਭਗਵਾਨ	ಭಗವಾನ
ਭਜਨਿਕ	ಭಜನಿಕ
ਭਰਪੂਰ	ಭರಪೂರ
ਭਾਘਵੀਨ੍ਦੇਰ	ಭಾಘವೀನ್ದೇರ
ਭਾਜ੍ਨਾਮ	ಭಾಜ್ನಾಮ
ਭਾਜ੍ਨਿਤ	ಭಾಜ್ನಿತ
ਭਾਵਜਿਤ	ಭಾವಜಿತ
ਭਾਵਜੀਨ੍ਦੇਰ	ಭಾವಜೀನ್ದೇರ
ਭਾਵਨਦੀਪ	ಭಾವನದೀಪ
ਭਾਵਨੀਤ	ಭಾವನೀತ
ਭਾਵਪਾਲ	ಭಾವಪಾಲ
ਭਾਵਪ੍ਰੇਮ	ಭಾವಪ್ರೇಮ
ਭਾਵਲੀਨ	ಭಾವಲೀನ
ਭੀਨਦੇਰ੍ਪਾਲ	ಭೀನದೇರ್ಪಾಲ
ਭੁਪੀਨ੍ਦੇਰ	ಭುಪೀನ್ದೇರ
ਮਂਗਲਾ	ಮಂಗಲಾ
ਮਂਤੇਕ	ಮಂತೇಕ
ਮਜਾਲ	ಮಜಾಲ
ਮਣਿਪਾਲ	ಮಣಿಪಾಲ
ਮਧੁਪ੍ਰਿਤ	ಮಧುಪ್ರಿತ
ਮਧੁਰਬੀਨ	ಮಧುರಬೀನ
ਮਧੁਵਂਤ	ಮಧುವಂತ
ਮਨਵਂਤ	ಮನವಂತ
ਮਰਦੁਲਾ	ಮರದುಲಾ
ਮਸ੍ਤਪ੍ਰੇਮ	ಮಸ್ತಪ್ರೇಮ
ਮਸ੍ਤਾਨ	ಮಸ್ತಾನ
ਮਸ੍ਤੁਕ	ಮಸ್ತುಕ
ਮਸ੍ਤ੍ਵੀਰ	ಮಸ್ತ್ವೀರ
ਮਹਨਬੀਰ	ಮಹನಬೀರ
ਮਹਾਜਿਤ	ಮಹಾಜಿತ
ਮਹਾਨਗਿਯਨ	ಮಹಾನಗಿಯನ
ਮਹਾਨਗੀਤ	ಮಹಾನಗೀತ
ਮਹਾਨਗੁਨ	ಮಹಾನಗುನ
ਮਹਾਨਜਿਤ	ಮಹಾನಜಿತ
ਮਹਾਨਜੀਵਨ	ಮಹಾನಜೀವನ
ਮਹਾਨਜੋਤ	ಮಹಾನಜೋತ
ਮਹਾਨਤੇਕ	ಮಹಾನತೇಕ
ਮਹਾਨਤ੍ਰੀਪਾਤ	ಮಹಾನತ್ರೀಪಾತ
ਮਹਾਨਦੀਪ	ಮಹಾನದೀಪ
ਮਹਾਨਪਾਲ	ಮಹಾನಪಾಲ
ਮਹਾਨਪ੍ਰੇਮ	ಮಹಾನಪ್ರೇಮ
ਮਹਾਨਭਗਤ	ಮಹಾನಭಗತ
ਮਹਿਨਦੇਰ੍ਪ੍ਰਿਤ	ಮಹಿನದೇರ್ಪ್ರಿತ
ਮਹੀਨਗਾ	ಮಹೀನಗಾ
ਮਹੀਨਦੇਰ੍ਪਾਲ	ಮಹೀನದೇರ್ಪಾಲ
ਮਹੇਕਪ੍ਰਿਤ	ಮಹೇಕಪ್ರಿತ
ਮਹੇਨਦੇਰ	ಮಹೇನದೇರ
ਮਹੇਰਬਾਨੀ	ಮಹೇರಬಾನೀ
ਮਹੇਸ਼ੀਨਦੇਰ	ಮಹೇಸ಼ೀನದೇರ
ਮਾਂਨਕਰਣ	ಮಾಂನಕರಣ
ਮਾਂਨਗਲ੍ਪ੍ਰਿਤ	ಮಾಂನಗಲ್ಪ್ರಿತ
ਮਾਂਨਵਾਨ੍ਤ੍ਬੀਰ	ಮಾಂನವಾನ್ತ್ಬೀರ
ਮਾਂਨਸੀਰਤ	ಮಾಂನಸೀರತ
ਮਾਂਨਾਵੀਨਦੇਰ	ಮಾಂನಾವೀನದೇರ
ਮਾਂਨਾਸਪ੍ਰੇਮ	ಮಾಂನಾಸಪ್ರೇಮ
ਮਾਂਨੀਨਦੇਰ੍ਬੀਰ	ಮಾಂನೀನದೇರ್ಬೀರ
ਮਾਂਨੋਹਾਰਜੋਤ	ಮಾಂನೋಹಾರಜೋತ
ਮਾਂਨੋਹਾਰਦੀਪ	ಮಾಂನೋಹಾರದೀಪ
ਮਾਂਨੋਹਾਰ੍ਜੀਤ	ಮಾಂನೋಹಾರ್ಜೀತ
ਮਾਂਨੋਹਾਰ੍ਪਲ	ಮಾಂನೋಹಾರ್ಪಲ
ਮਾਂਨ੍ਗਲ੍ਜੀਤ	ಮಾಂನ್ಗಲ್ಜೀತ
ਮਾਂਨ੍ਗਲ੍ਪ੍ਰੇਮ	ಮಾಂನ್ಗಲ್ಪ್ರೇಮ
ਮਾਂਨ੍ਸ਼ਿਤਾਲ	ಮಾಂನ್ಸ಼ಿತಾಲ
ਮਾਦਨਬੀਰ	ಮಾದನಬೀರ
ਮਾਦਾਨਕੀਰ੍ਪਾਲ	ಮಾದಾನಕೀರ್ಪಾಲ
ਮਾਦਾਨਪਾਲ	ಮಾದಾನಪಾಲ
ਮਾਨਤੇਜ	ಮಾನತೇಜ
ਮਾਨਦੇਵ	ಮಾನದೇವ
ਮਾਨਪੁਲ	ಮಾನಪುಲ
ਮਾਨਬੀਰ	ಮಾನಬೀರ
ਮਾਨਰਿਤ	ಮಾನರಿತ
ਮਾਨਾਸਦੀਪ	ಮಾನಾಸದೀಪ
ਮਾਨ੍ਕੀਰਣ	ಮಾನ್ಕೀರಣ
ਮਾਨ੍ਗਲ੍ਜੋਤ	ಮಾನ್ಗಲ್ಜೋತ
ਮਾਨ੍ਪ੍ਰੀਯਾ	ಮಾನ್ಪ್ರೀಯಾ
ਮਾਯ੍ਰਾਯ	ಮಾಯ್ರಾಯ
ਮਿਤ੍ਰਾ	ಮಿತ್ರಾ
ਮਿਤ੍ਰਾਜ	ಮಿತ್ರಾಜ
ਮੀਰਾ	ಮೀರಾ
ਮੁਕੁਂਦਾ	ಮುಕುಂದಾ
ਮੁਕੁਨਦ੍ਪ੍ਰਿਤ	ಮುಕುನದ್ಪ್ರಿತ
ਮੁਖ੍ਤਯਾਰ	ಮುಖ್ತಯಾರ
ਮੁਦ੍ਰਾ	ಮುದ್ರಾ
ਮੁਨਦੀਪ	ಮುನದೀಪ
ਮੁਨਲੇਨੇ	ಮುನಲೇನೇ
ਮੇਸ਼	ಮೇಸ಼
ਮੇਹਰ	ಮೇಹರ
ਮੇਹਾਰਤੇਕ	ಮೇಹಾರತೇಕ
ਮੇਹਾਰਪਲ	ಮೇಹಾರಪಲ
ਮੇਹਾਰਪ੍ਰਿਤ	ಮೇಹಾರಪ್ರಿತ
ਮੇਹਾਰਭੂਪ	ಮೇಹಾರಭೂಪ
ਮੇਹਾਰਮਿਤ	ಮೇಹಾರಮಿತ
ਮੇਹੇਰ	ಮೇಹೇರ
ਮੇਹੇਰਬਾਨੀ	ಮೇಹೇರಬಾನೀ
ਮੋਨੀਨ੍ਦੇਰ	ಮೋನೀನ್ದೇರ
ਮੋਹਨਤੇਕ	ಮೋಹನತೇಕ
ਮੋਹਨਮਿਤ	ಮೋಹನಮಿತ
ਮੋਹਨਲੀਨ	ಮೋಹನಲೀನ
ਮੋਹਨਵਂਤ	ಮೋಹನವಂತ
ਮੋਹਨਵੀਰ	ಮೋಹನವೀರ
ਮੋਹਿਨ੍ਦੇਰਪਾਲ	ಮೋಹಿನ್ದೇರಪಾಲ
ਮੋਹੇਨਪਲ	ಮೋಹೇನಪಲ
ਮੋਹੇਨਪ੍ਰਿਤ	ಮೋಹೇನಪ್ರಿತ
ਯਕਿਨ	ಯಕಿನ
ਯਸ਼ਜੋਤ	ಯಸ಼ಜೋತ
ਯਸ਼ਨੂਰ	ಯಸ಼ನೂರ
ਯਸ਼ਪਾਲ	ಯಸ಼ಪಾಲ
ਯਸ਼ਵਂਤ	ಯಸ಼ವಂತ
ਯਸ਼੍ਦੀਪ	ಯಸ಼್ದೀಪ
ਯਾਤੀਨਪਾਲ	ಯಾತೀನಪಾಲ
ਯਾਦਲੀਨ	ಯಾದಲೀನ
ਯਾਦਵੀਰ	ಯಾದವೀರ
ਯਾਦ੍ਬੀਰ	ಯಾದ್ಬೀರ
ਯਾਸ੍ਮੀਨੇ	ಯಾಸ್ಮೀನೇ
ਯੁਵਰਾਨੀ	ಯುವರಾನೀ
ਯੋਗੇਸ਼ਪਾਲ	ಯೋಗೇಸ಼ಪಾಲ
ਰਂਗ ਰਮਨ	ರಂಗ ರಮನ
ਰਂਗਜੋਤ	ರಂಗಜೋತ
ਰਂਗਪ੍ਰਿਤ	ರಂಗಪ್ರಿತ
ਰਂਗਾਤਮ	ರಂಗಾತಮ
ਰਂਗੀਵਨ	ರಂಗೀವನ
ਰਂਜੀਤ	ರಂಜೀತ
ਰਘੁਜਿਤ	ರಘುಜಿತ
ਰਘੁਬਂਸ	ರಘುಬಂಸ
ਰਚਨਜਿਤ	ರಚನಜಿತ
ਰਚਨਜੋਤ	ರಚನಜೋತ
ਰਚ੍ਪੀਨਦੇਰ੍ਜਿਤ	ರಚ್ಪೀನದೇರ್ಜಿತ
ਰਜੀਨਦਾਰ	ರಜೀನದಾರ
ਰਣਦੀਪ	ರಣದೀಪ
ਰਣਬੀਰ	ರಣಬೀರ
ਰਤਨ੍ਕਾਰਾਮ	ರತನ್ಕಾರಾಮ
ਰਤ੍ਤਾਨਜੋਤ	ರತ್ತಾನಜೋತ
ਰਤ੍ਤਾਨਦੀਪ	ರತ್ತಾನದೀಪ
ਰਨਗ੍ਰਤ੍ਤੀ	ರನಗ್ರತ್ತೀ
ਰਨਪ੍ਰਿਤ	ರನಪ್ರಿತ
ਰਪੀਨਦੇਰ	ರಪೀನದೇರ
ਰਮਚੇਤਨ	ರಮಚೇತನ
ਰਮਣੀਕ	ರಮಣೀಕ
ਰਮਨਜਿਤ	ರಮನಜಿತ
ਰਮਨਦੀਪ	ರಮನದೀಪ
ਰਮਨਿਤ	ರಮನಿತ
ਰਮਨੀਵਾਸ	ರಮನೀವಾಸ
ਰਮਲੀਨ	ರಮಲೀನ
ਰਮਾਂਨਜੋਤ	ರಮಾಂನಜೋತ
ਰਮਾਂਨਰੂਪ	ರಮಾಂನರೂಪ
ਰਮਾਂਨਸੁਖ	ರಮಾಂನಸುಖ
ਰਮਿਤ	ರಮಿತ
ਰਮਿਨਾਜੀਤ	ರಮಿನಾಜೀತ
ਰਮੀਨਦੇਰ੍ਜਿਤ	ರಮೀನದೇರ್ಜಿತ
ਰਮੀਨਦੇਰ੍ਪਾਲ	ರಮೀನದೇರ್ಪಾಲ
ਰਮੀਨਦੇਰ੍ਪ੍ਰਿਤ	ರಮೀನದೇರ್ಪ್ರಿತ
ਰਮੀਨਦੇਰ੍ਬੀਰ	ರಮೀನದೇರ್ಬೀರ
ਰਮੇਸ਼ਪਲ	ರಮೇಸ಼ಪಲ
ਰਮੇਸ਼ਮਿਤ	ರಮೇಸ಼ಮಿತ
ਰਵਜੋਤ	ರವಜೋತ
ਰਵਨੀਤ	ರವನೀತ
ਰਵਿਨ੍ਦਰ	ರವಿನ್ದರ
ਰਵਿਰਾਜ	ರವಿರಾಜ
ਰਵੀਦੀਪ	ರವೀದೀಪ
ਰਵੀਨਦੇਰ੍ਦੀਪ	ರವೀನದೇರ್ದೀಪ
ਰਵੀਨਦੇਰ੍ਮਿਤ	ರವೀನದೇರ್ಮಿತ
ਰਸਂਜਿਤ	ರಸಂಜಿತ
ਰਸਂਜੋਤ	ರಸಂಜೋತ
ਰਸਂਮਿਤ	ರಸಂಮಿತ
ਰਸਗੁਨ	ರಸಗುನ
ਰਸਜੋਤ	ರಸಜೋತ
ਰਸਧਾਰਮ	ರಸಧಾರಮ
ਰਸਨਂਦ	ರಸನಂದ
ਰਸਪ੍ਰਿਤ	ರಸಪ್ರಿತ
ਰਸਬੀਰ	ರಸಬೀರ
ਰਸਭਾਗਤ	ರಸಭಾಗತ
ਰਸਮ	ರಸಮ
ਰਸਮ੍ਰਿਤ	ರಸಮ್ರಿತ
ਰਸਲੀਨ	ರಸಲೀನ
ਰਸਵਂਤ	ರಸವಂತ
ਰਸ਼ਾਨ੍ਪ੍ਰਿਤ	ರಸ಼ಾನ್ಪ್ರಿತ
ਰਸੁਤ੍ਤਮ	ರಸುತ್ತಮ
ਰਹੁਲਜੀਤ	ರಹುಲಜೀತ
ਰਹੁਲਦੀਪ	ರಹುಲದೀಪ
ਰਾਖਨਾਂ	ರಾಖನಾಂ
ਰਾਖਬੀਰ	ರಾಖಬೀರ
ਰਾਜਕਿਰਣ	ರಾಜಕಿರಣ
ਰਾਜਦੀਪ	ರಾಜದೀಪ
ਰਾਜਨਾਰੀਨ੍ਦ	ರಾಜನಾರೀನ್ದ
ਰਾਜਪਰਾਮ	ರಾಜಪರಾಮ
ਰਾਜਪਾਲ	ರಾಜಪಾಲ
ਰਾਜਪ੍ਰਤਾਪ	ರಾಜಪ್ರತಾಪ
ਰਾਜਮਂਦਰ	ರಾಜಮಂದರ
ਰਾਜਮਿਤ	ರಾಜಮಿತ
ਰਾਜਸ਼ਰਣ	ರಾಜಸ಼ರಣ
ਰਾਜਸੁਖ	ರಾಜಸುಖ
ਰਾਜਾਨਜਿਤ	ರಾಜಾನಜಿತ
ਰਾਜਾਨਮਿਤ	ರಾಜಾನಮಿತ
ਰਾਜਾਨ੍ਦੀਪ	ರಾಜಾನ್ದೀಪ
ਰਾਤਾਨਗੀਤ	ರಾತಾನಗೀತ
ਰਾਤਾਨਚੇਤਨ	ರಾತಾನಚೇತನ
ਰਾਤਾਨਜੀਵਨ	ರಾತಾನಜೀವನ
ਰਾਤਾਨਪ੍ਰਿਤ	ರಾತಾನಪ್ರಿತ
ਰਾਤਾਨਮਿਤ	ರಾತಾನಮಿತ
ਰਾਤਾਨਵਂਤ	ರಾತಾನವಂತ
ਰਾਤਾਨਾਤਮ	ರಾತಾನಾತಮ
ਰਾਮਦਾਸ	ರಾಮದಾಸ
ਰਾਮਪਾਲ	ರಾಮಪಾಲ
ਰਾਮਰਂਗ	ರಾಮರಂಗ
ਰਾਮਰਤ੍ਤਨ	ರಾಮರತ್ತನ
ਰਾਮਸੁਖ	ರಾಮಸುಖ
ਰਾਸਰਮਣ	ರಾಸರಮಣ
ਰਾਸ਼੍ਪਲ	ರಾಸ಼್ಪಲ
ਰਾਸ਼੍ਮੀਨਦੇਰ	ರಾಸ಼್ಮೀನದೇರ
ਰਿਧਿਮਾ	ರಿಧಿಮಾ
ਰੀਜਕ	ರೀಜಕ
ਰੀਤੀਨਦੇਰ	ರೀತೀನದೇರ
ਰੀਪਨ੍ਜੋਤ	ರೀಪನ್ಜೋತ
ਰੀਪੁਦਮ	ರೀಪುದಮ
ਰੂਂਗ / ਰਂਗ	ರೂಂಗ / ರಂಗ
ਰੂਪਦੀਪ	ರೂಪದೀಪ
ਰੂਪਦੇਵ	ರೂಪದೇವ
ਰੂਪਵਂਤ	ರೂಪವಂತ
ਰੇਗੇਨਦਰ	ರೇಗೇನದರ
ਰੋਸ਼ਨਦੀਪ	ರೋಸ಼ನದೀಪ
ਰੌਸ਼ਾਨਪ੍ਰੇਮ	ರೌಸ಼ಾನಪ್ರೇಮ
ਰੌਸ਼ਾਨਬੀਰ	ರೌಸ಼ಾನಬೀರ
ਲਕ੍ਸ਼੍ਮੀ	ಲಕ್ಸ಼್ಮೀ
ਲਖਪ੍ਰਿਤ	ಲಖಪ್ರಿತ
ਲਖਮਿਤ	ಲಖಮಿತ
ਲਖਰੂਪ	ಲಖರೂಪ
ਲਖਵੀਰ	ಲಖವೀರ
ਲਵੇਨਿਤ	ಲವೇನಿತ
ਲਾਜਵਂਤ	ಲಾಜವಂತ
ਲਾਵਪ੍ਰਿਤ	ಲಾವಪ್ರಿತ
ਲਾਵਿਨਦੀਪ	ಲಾವಿನದೀಪ
ਲੀਵਗੀਆਨ	ಲೀವಗೀಆನ
ਲੀਵਚਿਤ	ಲೀವಚಿತ
ਲੀਵਚੇਤ	ಲೀವಚೇತ
ਲੀਵਜੋਤ	ಲೀವಜೋತ
ਲੀਵਨਾਮ	ಲೀವನಾಮ
ਲੀਵਸ਼ਰਣ	ಲೀವಸ಼ರಣ
ਲੀਵਾਵਤਰ	ಲೀವಾವತರ
ਲੋਕਪਾਲ	ಲೋಕಪಾಲ
ਲੋਕਪ੍ਰਿਤ	ಲೋಕಪ್ರಿತ
ਲੋਕਰੂਪ	ಲೋಕರೂಪ
ਲੋਕ੍ਪ੍ਰੇਮ	ಲೋಕ್ಪ್ರೇಮ
ਲੋਵਪ੍ਰੇਮ	ಲೋವಪ್ರೇಮ
ਲੋਵੇਦੀਪ	ಲೋವೇದೀಪ
ਵਰੀਨਦੇਰ੍ਪਾਲ	ವರೀನದೇರ್ಪಾಲ
ਵਰੁਨਜਿਤ	ವರುನಜಿತ
ਵਰੁਨਦੀਪ	ವರುನದೀಪ
ਵਸਂਤਪ੍ਰਿਤ	ವಸಂತಪ್ರಿತ
ਵਸੁਂਧਰਾ	ವಸುಂಧರಾ
ਵਾਦਭਾਗ	ವಾದಭಾಗ
ਵਾਮਾਂਨਜੀਤ	ವಾಮಾಂನಜೀತ
ਵਾਰੀਨਦੇਰ	ವಾರೀನದೇರ
ਵਾਸੀਮਬੀਰ	ವಾಸೀಮಬೀರ
ਵਾਹੀਦਪ੍ਰਿਤ	ವಾಹೀದಪ್ರಿತ
ਵਾਹੇਗੁਰੁ	ವಾಹೇಗುರು
ਵਿਕ੍ਰਮਜੀਤ	ವಿಕ್ರಮಜೀತ
ਵਿਕ੍ਰਮਜੋਤ	ವಿಕ್ರಮಜೋತ
ਵਿਚਾਰ੍ਚੇਤਨ	ವಿಚಾರ್ಚೇತನ
ਵਿਚਾਰ੍ਦੀਪ	ವಿಚಾರ್ದೀಪ
ਵਿਚਾਰ੍ਲੀਨ	ವಿಚಾರ್ಲೀನ
ਵਿਜਯਪ੍ਰਤਾਪ	ವಿಜಯಪ್ರತಾಪ
ਵਿਜਯਪ੍ਰਿਤ	ವಿಜಯಪ್ರಿತ
ਵਿਜੇਂਦਰ	ವಿಜೇಂದರ
ਵਿਨਾਯਦੀਪ	ವಿನಾಯದೀಪ
ਵਿਨਾਯਪੁਲ	ವಿನಾಯಪುಲ
ਵਿਨਾਯ੍ਬਿਰ	ವಿನಾಯ್ಬಿರ
ਵਿਮਾਂਲਜਿਤ	ವಿಮಾಂಲಜಿತ
ਵਿਮਾਂਲਜੋਤ	ವಿಮಾಂಲಜೋತ
ਵਿਮਾਂਲਪ੍ਰੇਮ	ವಿಮಾಂಲಪ್ರೇಮ
ਵਿਰੀਨਦਾਰ ; ਵਿਰੀਨਦੇਰ	ವಿರೀನದಾರ ; ವಿರೀನದೇರ
ਵਿਰੀਨਦੇਰ	ವಿರೀನದೇರ
ਵਿਸਮਦ	ವಿಸಮದ
ਵਿਸ਼ਾਲਦੀਪ	ವಿಸ಼ಾಲದೀಪ
ਵਿਸ਼ਾਲਪ੍ਰਿਤ	ವಿಸ಼ಾಲಪ್ರಿತ
ਵਿਸ਼੍ਵਰ੍ਪ੍ਰਿਤ	ವಿಸ಼್ವರ್ಪ್ರಿತ
ਵਿਸ਼੍ਵਾਤਮ	ವಿಸ಼್ವಾತಮ
ਵਿਸਾਹ	ವಿಸಾಹ
ਵੀਜਯਮਿਤ	ವೀಜಯಮಿತ
ਵੀਰ	ವೀರ
ਵੀਰ /ਵੀਰ	ವೀರ /ವೀರ
ਵੀਰਪਾਲ	ವೀರಪಾಲ
ਵੀਵੇਕ੍ਬੀਰ	ವೀವೇಕ್ಬೀರ
ਵੀਸ੍ਰਮਣ	ವೀಸ್ರಮಣ
ਵੇਰਾਜ	ವೇರಾಜ
ਵੈਭਵ	ವೈಭವ
ਸਂਗਜਾਪ	ಸಂಗಜಾಪ
ਸਂਗਤਪ੍ਰਿਤ	ಸಂಗತಪ್ರಿತ
ਸਂਗਤਰੂਪ	ಸಂಗತರೂಪ
ਸਂਗਤ੍ਰਸ	ಸಂಗತ್ರಸ
ਸਂਗੀਤਾ	ಸಂಗೀತಾ
ਸਂਗ੍ਰਾਮ	ಸಂಗ್ರಾಮ
ਸਂਜੀਤ	ಸಂಜೀತ
ਸਂਜੋਗ	ಸಂಜೋಗ
ਸਂਤਕੀਰੀਨ	ಸಂತಕೀರೀನ
ਸਂਤਪ੍ਰਕਾਸ਼	ಸಂತಪ್ರಕಾಸ಼
ਸਂਤਪ੍ਰੇਮ	ಸಂತಪ್ರೇಮ
ਸਂਤਬੀਰ	ಸಂತಬೀರ
ਸਂਤੋਖਜੀਤ	ಸಂತೋಖಜೀತ
ਸਂਤੋਖਜੋਤ	ಸಂತೋಖಜೋತ
ਸਂਤੋਖਪ੍ਰਿਤ	ಸಂತೋಖಪ್ರಿತ
ਸਂਤੋਖਬੀਰ	ಸಂತೋಖಬೀರ
ਸਂਦੀਪ	ಸಂದೀಪ
ਸਗਲਜੋਤ	ಸಗಲಜೋತ
ਸਚਕਿਰਤ	ಸಚಕಿರತ
ਸਚਜੋਗ	ಸಚಜೋಗ
ਸਚਪਾਲ	ಸಚಪಾಲ
ਸਚਪ੍ਰਧਾਨ	ಸಚಪ್ರಧಾನ
ਸਚਭਾਗਤ	ಸಚಭಾಗತ
ਸਚਮਾਨ	ಸಚಮಾನ
ਸਚਰੂਪ	ಸಚರೂಪ
ਸਚਵੀਰ	ಸಚವೀರ
ਸਚਸੁਖ	ಸಚಸುಖ
ਸਚਸੇਵਕ	ಸಚಸೇವಕ
ਸਚਾਮ੍ਰਿਤ	ಸಚಾಮ್ರಿತ
ਸਚ੍ਦੀਪ	ಸಚ್ದೀಪ
ਸਜੀਨਦੇਰ	ಸಜೀನದೇರ
ਸਤਕਿਰਤ	ಸತಕಿರತ
ਸਤਕੀਰਤ	ಸತಕೀರತ
ਸਤਕੀਰ੍ਤਨ	ಸತಕೀರ್ತನ
ਸਤਗੁਨ	ಸತಗುನ
ਸਤਗੁਰ	ಸತಗುರ
ਸਤਜੋਤ	ಸತಜೋತ
ਸਤਨਾਮ	ಸತನಾಮ
ਸਤਪਾਲ	ಸತಪಾಲ
ਸਤਪ੍ਰਕਾਸ਼	ಸತಪ್ರಕಾಸ಼
ਸਤਪ੍ਰਿਤ	ಸತಪ್ರಿತ
ਸਤਪ੍ਰੇਮ	ಸತಪ್ರೇಮ
ਸਤਬਚਨ	ಸತಬಚನ
ਸਤਮਿਤ	ಸತಮಿತ
ਸਤਰਜਿਤ	ಸತರಜಿತ
ਸਤਰਾਜ	ಸತರಾಜ
ਸਤਲੀਨ	ಸತಲೀನ
ਸਤਵਂਤ	ಸತವಂತ
ਸਤਸਂਗਤ	ಸತಸಂಗತ
ਸਤਸਂਤੋਖ	ಸತಸಂತೋಖ
ਸਤਸਰਂਗ	ಸತಸರಂಗ
ਸਤਸੁਖ	ಸತಸುಖ
ਸਤੀਨਦੇਰ੍ਜਿਤ	ಸತೀನದೇರ್ಜಿತ
ਸਤ੍ਯਜਿਤ	ಸತ್ಯಜಿತ
ਸਤ੍ਯਪ੍ਰੇਮ	ಸತ್ಯಪ್ರೇಮ
ਸਥਿਨ੍ਦਰ	ಸಥಿನ್ದರ
ਸਦਜੀਵਨ	ಸದಜೀವನ
ਸਦਸੁਖ	ಸದಸುಖ
ਸਨਮੁਖ	ಸನಮುಖ
ਸਨਾਨਤਨ	ಸನಾನತನ
ਸਪਨਦੀਪ	ಸಪನದೀಪ
ਸਪਾਹੀ	ಸಪಾಹೀ
ਸਬੂਰੀ	ಸಬೂರೀ
ਸਭਾਜੀਤ	ಸಭಾಜೀತ
ਸਮਰਜੀਤ	ಸಮರಜೀತ
ਸਮਰਣ	ಸಮರಣ
ਸਮਰਵੀਰ	ಸಮರವೀರ
ਸਮਰ੍ਥ	ಸಮರ್ಥ
ਸਮਾਂਰਬੀਰ	ಸಮಾಂರಬೀರ
ਸਮਾਂਰ੍ਜੋਤ	ಸಮಾಂರ್ಜೋತ
ਸਮਾਈ	ಸಮಾಈ
ਸਮੀਨਦੀਪ	ಸಮೀನದೀಪ
ਸਮੀਰ	ಸಮೀರ
ਸਰਦਾਰ	ಸರದಾರ
ਸਰਨਦਾਯਲ	ಸರನದಾಯಲ
ਸਰਨਦੀਪ	ಸರನದೀಪ
ਸਰਨਾਗਤ	ಸರನಾಗತ
ਸਰਬਜੀਤ / ਸਰਬਜੀਤ	ಸರಬಜೀತ / ಸರಬಜೀತ
ਸਰਬਨੀਵਾਸ	ಸರಬನೀವಾಸ
ਸਰਬਪ੍ਰਿਤ	ಸರಬಪ್ರಿತ
ਸਰਬਸੁਖ	ಸರಬಸುಖ
ਸਰਬੁਤ੍ਤਮ	ಸರಬುತ್ತಮ
ਸਰਬ੍ਗਿਆਨ	ಸರಬ್ಗಿಆನ
ਸਰਬ੍ਜਿਤ	ಸರಬ್ಜಿತ
ਸਰਬ੍ਦਾਯਲ	ಸರಬ್ದಾಯಲ
ਸਰਬ੍ਦੀਪ	ಸರಬ್ದೀಪ
ਸਰਬ੍ਦੇਵ	ಸರಬ್ದೇವ
ਸਰਬ੍ਧਾਰਾਮ	ಸರಬ್ಧಾರಾಮ
ਸਰਲਜਿਤ	ಸರಲಜಿತ
ਸਰਲਬੀਰ	ಸರಲಬೀರ
ਸਰਾਬ੍ਰਜ	ಸರಾಬ್ರಜ
ਸਰੂਪ	ಸರೂಪ
ਸਰੂਰ	ಸರೂರ
ਸਰ੍ਜਿਤ	ಸರ್ಜಿತ
ਸਰ੍ਮੀਨਦੇਰ	ಸರ್ಮೀನದೇರ
ਸਵਾਨਪ੍ਰਿਤ	ಸವಾನಪ್ರಿತ
ਸਵਾਰਜਦੀਪ	ಸವಾರಜದೀಪ
ਸਵਾਰਜਬੀਰ	ಸವಾರಜಬೀರ
ਸਵਾਰਨਜੋਤ	ಸವಾರನಜೋತ
ਸਵਾਰਨਪ੍ਰਿਤ	ಸವಾರನಪ್ರಿತ
ਸਵੀਤੀਨਦੇਰ	ಸವೀತೀನದೇರ
ਸਵੀਤੋਜ	ಸವೀತೋಜ
ਸਵੀਨਦੇਰ	ಸವೀನದೇರ
ਸਹੀਲਮਿਤ	ಸಹೀಲಮಿತ
ਸ਼ਯ੍ਮ੍ਸੁਨ੍ਦਾਰ	ಸ಼ಯ್ಮ್ಸುನ್ದಾರ
ਸ਼ਰਨਪਾਲ	ಸ಼ರನಪಾಲ
ਸ਼ਰਨਬੀਰ	ಸ಼ರನಬೀರ
ਸ਼ਰਨ੍ਜੀਤ੍ਕੌਰ	ಸ಼ರನ್ಜೀತ್ಕೌರ
ਸ਼ਾਂਤਚਿਤ	ಸ಼ಾಂತಚಿತ
ਸ਼ਾਂਤਦੀਪ	ಸ಼ಾಂತದೀಪ
ਸ਼ਾਂਤਪ੍ਰਕਾਸ਼	ಸ಼ಾಂತಪ್ರಕಾಸ಼
ਸ਼ਾਂਤਪ੍ਰਿਤ	ಸ಼ಾಂತಪ್ರಿತ
ਸ਼ਾਂਤਬੀਰ	ಸ಼ಾಂತಬೀರ
ਸ਼ਾਂਤਲੀਨ	ಸ಼ಾಂತಲೀನ
ਸ਼ਾਨਤ੍ਨੀਵਾਸ	ಸ಼ಾನತ್ನೀವಾಸ
ਸ਼ਾਬਦਚੇਤ	ಸ಼ಾಬದಚೇತ
ਸ਼ਾਬਦਤੇਕ	ಸ಼ಾಬದತೇಕ
ਸ਼ਾਬਦ੍ਰਾਸ	ಸ಼ಾಬದ್ರಾಸ
ਸ਼ਾਬਾਦ੍ਦੀਪ	ಸ಼ಾಬಾದ್ದೀಪ
ਸ਼ਾਲੀਨ	ಸ಼ಾಲೀನ
ਸ਼ਾਸ਼ੀਪ੍ਰਿਤ	ಸ಼ಾಸ಼ೀಪ್ರಿತ
ਸ਼ਿਵਚਰਣ	ಸ಼ಿವಚರಣ
ਸ਼ਿਵ੍ਚਾਰਨ੍ਜੀਤ	ಸ಼ಿವ್ಚಾರನ್ಜೀತ
ਸ਼ੁਕਾਰਿਯਨ	ಸ಼ುಕಾರಿಯನ
ਸ਼ੁਭਦੀਪ	ಸ಼ುಭದೀಪ
ਸ਼ੂਰਵੀਰ	ಸ಼ೂರವೀರ
ਸ਼ੇਰ	ಸ಼ೇರ
ਸ਼ੇਰਪੁਲ	ಸ಼ೇರಪುಲ
ਸ਼ੇਰਬਹਾਦੁਰ	ಸ಼ೇರಬಹಾದುರ
ਸ਼ੇਹ੍ਬਾਝ	ಸ಼ೇಹ್ಬಾಝ
ਸਾਕਰਥ	ಸಾಕರಥ
ਸਾਖ	ಸಾಖ
ਸਾਗਰ	ಸಾಗರ
ਸਾਜ	ಸಾಜ
ਸਾਤਪੁਲ	ಸಾತಪುಲ
ਸਾਧਨਾਹ	ಸಾಧನಾಹ
ਸਾਧਿਕਾ	ಸಾಧಿಕಾ
ਸਾਬਰ	ಸಾಬರ
ਸਾਰ	ಸಾರ
ਸਿਂਦਾ	ಸಿಂದಾ
ਸਿਓਪਰਿਤ	ಸಿಓಪರಿತ
ਸਿਤਾਲਜੀਤ	ಸಿತಾಲಜೀತ
ਸਿਤਾਲਜੋਤ	ಸಿತಾಲಜೋತ
ਸਿਮਰਨ	ಸಿಮರನ
ਸੀਖਲ	ಸೀಖಲ
ਸੀਮਾਂਰ੍ਜਿਤ	ಸೀಮಾಂರ್ಜಿತ
ਸੀਮਾਂਰ੍ਨਾਮ	ಸೀಮಾಂರ್ನಾಮ
ਸੀਮਾਂਰ੍ਪ੍ਰਿਤ	ಸೀಮಾಂರ್ಪ್ರಿತ
ਸੀਮਾਂਰ੍ਲੀਨ	ಸೀಮಾಂರ್ಲೀನ
ਸੀਮ੍ਰਤ	ಸೀಮ್ರತ
ਸੀਮ੍ਰਨਪਾਲ	ಸೀಮ್ರನಪಾಲ
ਸੀਮ੍ਰਨਪ੍ਰਿਤ	ಸೀಮ್ರನಪ್ರಿತ
ਸੀਮ੍ਰਨ੍ਕੌਰ	ಸೀಮ್ರನ್ಕೌರ
ਸੀਮ੍ਰਨ੍ਜੀਤ	ಸೀಮ್ರನ್ಜೀತ
ਸੀਮ੍ਰੀਤਾ	ಸೀಮ್ರೀತಾ
ਸੀਰਤ	ಸೀರತ
ਸੀਰੀਪ੍ਰੀਤਮ	ಸೀರೀಪ್ರೀತಮ
ਸੀਰੀਵੇਦ੍ਯਾ	ಸೀರೀವೇದ್ಯಾ
ਸੀਰੀਸੀਮ੍ਰਣ	ಸೀರೀಸೀಮ್ರಣ
ਸੀਰੀਸੇਵਾ	ಸೀರೀಸೇವಾ
ਸੁਖਚੈਨ	ಸುಖಚೈನ
ਸੁਖਜੀਵਨ	ಸುಖಜೀವನ
ਸੁਖਜੋਤ	ಸುಖಜೋತ
ਸੁਖਜੋਧ	ಸುಖಜೋಧ
ਸੁਖਦਾਯਲ	ಸುಖದಾಯಲ
ਸੁਖਦੀਪ	ಸುಖದೀಪ
ਸੁਖਦੇਵ	ಸುಖದೇವ
ਸੁਖਬੀਰ	ಸುಖಬೀರ
ਸੁਖਮਾਂ	ಸುಖಮಾಂ
ਸੁਖਰੂਪ	ಸುಖರೂಪ
ਸੁਖਸਿਤਾਲ	ಸುಖಸಿತಾಲ
ਸੁਖਸੀਮ੍ਰਣ	ಸುಖಸೀಮ್ರಣ
ਸੁਖਾਨਂਦ	ಸುಖಾನಂದ
ਸੁਖਿਤ	ಸುಖಿತ
ਸੁਖੀਨ	ಸುಖೀನ
ਸੁਖੀਨ੍ਦੇਰ	ಸುಖೀನ್ದೇರ
ਸੁਖ੍ਚਾਰਨ੍ਜੀਤ	ಸುಖ್ಚಾರನ್ಜೀತ
ਸੁਖ੍ਜਿਤ	ಸುಖ್ಜಿತ
ਸੁਚਦੀਪ	ಸುಚದೀಪ
ਸੁਚਦੇਵ	ಸುಚದೇವ
ਸੁਚਮ	ಸುಚಮ
ਸੁਜਨਰੂਪ	ಸುಜನರೂಪ
ਸੁਜਨ੍ਬੀਰ	ಸುಜನ್ಬೀರ
ਸੁਜ੍ਜਨ	ಸುಜ್ಜನ
ਸੁਧਬੁਧ	ಸುಧಬುಧ
ਸੁਧਸੁਰਤ	ಸುಧಸುರತ
ਸੁਭਪ੍ਰਿਤ	ಸುಭಪ್ರಿತ
ਸੁਹੇਜਦੀਪ	ಸುಹೇಜದೀಪ
ਸੇਵਾਕਪ੍ਰਿਤ	ಸೇವಾಕಪ್ರಿತ
ਸੇਵਾਕਪ੍ਰੇਮ	ಸೇವಾಕಪ್ರೇಮ
ਸੇਵਾਕਰਣ	ಸೇವಾಕರಣ
ਸੇਵਾਪ੍ਰੀਤ	ಸೇವಾಪ್ರೀತ
ਸੇਹਜ	ಸೇಹಜ
ਸੇਹੇਜਬੀਰ	ಸೇಹೇಜಬೀರ
ਸੈਲੇਸ਼ਦੀਪ	ಸೈಲೇಸ಼ದೀಪ
ਸੈਹਜ	ಸೈಹಜ
ਸੈਹਾਜਨੀਵਾਸ	ಸೈಹಾಜನೀವಾಸ
ਸੈਹਾਜਲੀਨ	ಸೈಹಾಜಲೀನ
ਸੈਹਾਜਾਧਾਰ	ಸೈಹಾಜಾಧಾರ
ਸੋਚੀ	ಸೋಚೀ
ਸੋਨਹਨ	ಸೋನಹನ
ਸੋਭਾਵਂਤ	ಸೋಭಾವಂತ
ਸੋਹੀਨਦੇਰ	ಸೋಹೀನದೇರ
ਸੋਹੁਨ	ಸೋಹುನ
ਸ੍ਵਰ੍ਨ	ಸ್ವರ್ನ
ਹਕਾਮਪ੍ਰਿਤ	ಹಕಾಮಪ್ರಿತ
ਹਨ੍ਸ੍ਪਾਲ	ಹನ್ಸ್ಪಾಲ
ਹਰਕਾਨ੍ਵਾਲ	ಹರಕಾನ್ವಾಲ
ਹਰਕੀਰਣ	ಹರಕೀರಣ
ਹਰਗੀਤ	ಹರಗೀತ
ਹਰਗੁਰ੍ਮਿਤ (ਮਿਤ )	ಹರಗುರ್ಮಿತ (ಮಿತ )
ਹਰਗੋਬੀਨ੍ਦ	ಹರಗೋಬೀನ್ದ
ਹਰਚਰਣ	ಹರಚರಣ
ਹਰਜਪ	ಹರಜಪ
ਹਰਜੀ	ಹರಜೀ
ਹਰਜੀਤ	ಹರಜೀತ
ਹਰਜੀਨ੍ਦੇਰ	ಹರಜೀನ್ದೇರ
ਹਰਜੀਵ	ಹರಜೀವ
ਹਰਜੁਗਤ	ಹರಜುಗತ
ਹਰਜੋਗ	ಹರಜೋಗ
ਹਰਜੋਧ	ಹರಜೋಧ
ਹਰਜ੍ਯੋਤ	ಹರಜ್ಯೋತ
ਹਰਤਿਰਥ	ಹರತಿರಥ
ਹਰਤੇਜ੍ਪਾਲ	ಹರತೇಜ್ಪಾಲ
ਹਰਦਯਾਲ	ಹರದಯಾಲ
ਹਰਦਾਸ	ಹರದಾಸ
ਹਰਦਿਪਾ	ಹರದಿಪಾ
ਹਰਦੀਪ	ಹರದೀಪ
ਹਰਧਨ	ಹರಧನ
ਹਰਨਾਮ	ಹರನಾಮ
ਹਰਨਾਰਾਯਣ	ಹರನಾರಾಯಣ
ਹਰਨਿਤ	ಹರನಿತ
ਹਰਨੀਰ੍ਮਲ	ಹರನೀರ್ಮಲ
ਹਰਨੀਹਲ	ಹರನೀಹಲ
ਹਰਪਰ੍ਸਨ੍ਨ	ಹರಪರ್ಸನ್ನ
ਹਰਪਾਲ	ಹರಪಾಲ
ਹਰਪ੍ਰੇਮ੍ਜੀਤ	ಹರಪ್ರೇಮ್ಜೀತ
ਹਰਬਿਂਦਰ	ಹರಬಿಂದರ
ਹਰਬਿਰ	ಹರಬಿರ
ਹਰਭਗਤ	ಹರಭಗತ
ਹਰਮਨਾਦ	ಹರಮನಾದ
ਹਰਮਾਂਨ੍ਦੇਰ	ಹರಮಾಂನ್ದೇರ
ਹਰਮੀਤ	ಹರಮೀತ
ਹਰਮੀਲਨ	ಹರಮೀಲನ
ਹਰਮੂਰਤ	ಹರಮೂರತ
ਹਰਰਾਈ	ಹರರಾಈ
ਹਰਰੂਪ	ಹರರೂಪ
ਹਰਵਂਤ	ಹರವಂತ
ਹਰਵਿਨ	ಹರವಿನ
ਹਰਸ਼ਰਣ	ಹರಸ಼ರಣ
ਹਰਸਿਤਾਲ	ಹರಸಿತಾಲ
ਹਰਸੀਮ੍ਰਣ	ಹರಸೀಮ್ರಣ
ਹਰਸੀਮ੍ਰਨ੍ਜੋਤ	ಹರಸೀಮ್ರನ್ಜೋತ
ਹਰਸੀਮ੍ਰਿਤ	ಹರಸೀಮ್ರಿತ
ਹਰਸੁਖ	ಹರಸುಖ
ਹਰਾਨੂਪ	ಹರಾನೂಪ
ਹਰਾਮ੍ਰੀਤ	ಹರಾಮ್ರೀತ
ਹਰਿਕੀਰ੍ਤਨ	ಹರಿಕೀರ್ತನ
ਹਰਿਦਰ੍ਸ਼ਨ	ಹರಿದರ್ಸ಼ನ
ਹਰਿਨਾਰਾਯਣ	ಹರಿನಾರಾಯಣ
ਹਰਿਪ੍ਰੀਤ	ಹರಿಪ್ರೀತ
ਹਰੀਅਮ੍ਰਿਤ	ಹರೀಅಮ್ರಿತ
ਹਰੀਸਰੂਪ	ಹರೀಸರೂಪ
ਹਰੀਸੀਮਾਂਰਣ	ಹರೀಸೀಮಾಂರಣ
ਹਰ੍ਕਾਰਾਨ੍ਜੀਤ	ಹರ್ಕಾರಾನ್ಜೀತ
ਹਰ੍ਕੀਰਨ੍ਜੀਤ	ಹರ್ಕೀರನ್ಜೀತ
ਹਰ੍ਕੀਰਪਾਲ	ಹರ್ಕೀರಪಾಲ
ਹਰ੍ਜਸ	ಹರ್ಜಸ
ਹਰ੍ਤੇਇਜ	ಹರ್ತೇಇಜ
ਹਰ੍ਨੀਝ	ಹರ್ನೀಝ
ਹਰ੍ਬਂਸ	ಹರ್ಬಂಸ
ਹਰ੍ਮਾਂਨਜਿਤ	ಹರ್ಮಾಂನಜಿತ
ਹਰ੍ਮਾਂਨਪਾਲ	ಹರ್ಮಾಂನಪಾಲ
ਹਰ੍ਮੀਨ੍ਦੇਰ	ಹರ್ಮೀನ್ದೇರ
ਹਰ੍ਮੇਂਦ੍ਰ	ಹರ್ಮೇಂದ್ರ
ਹਰ੍ਸ਼ਰ੍ਧਾ	ಹರ್ಸ಼ರ್ಧಾ
ਹਰ੍ਸ਼ਵਰ੍ਧਨ	ಹರ್ಸ಼ವರ್ಧನ
ਹਰ੍ਸ਼ਾਗੁਨ	ಹರ್ಸ಼ಾಗುನ
ਹਰ੍ਸਿਰਤ	ಹರ್ಸಿರತ
ਹਸਨ	ಹಸನ
ਹਾਰਭਾਗ	ಹಾರಭಾಗ
ਹਿਤੀਨਦੇਰ	ಹಿತೀನದೇರ
ਹਿਤੇਨਦੇਰ	ಹಿತೇನದೇರ
ਹਿਮ੍ਮਤ	ಹಿಮ್ಮತ
ਹਿਰੀਸ਼	ಹಿರೀಸ಼
ਹੁਅਲੀਨਾ	ಹುಅಲೀನಾ
ਹੁਕੁਮਪਰਿਤ	ಹುಕುಮಪರಿತ
ਹੂਜਓਏ	ಹೂಜಓಏ
ਹੇਤ	ಹೇತ
ਹੇਤਬੀਰ	ಹೇತಬೀರ
ਹੇਮੀਨਦੇਰ	ಹೇಮೀನದೇರ
ਹੇਯ੍ਮਾਂਨ੍ਪ੍ਰਿਤ	ಹೇಯ್ಮಾಂನ್ಪ್ರಿತ
ਹੇਰਹੋ	ಹೇರಹೋ
#
#
# Territory names from CLDR
ਅਸੈਂਸ਼ਨ ਟਾਪੂ	ಅಸೈಂಸ಼ನ ಟಾಪೂ
ਅੰਡੋਰਾ	ಅಡೋರಾ
ਸੰਯੁਕਤ ਅਰਬ ਅਮੀਰਾਤ	ಸಯುಕತ ಅರಬ ಅಮೀರಾತ
ਅਫ਼ਗਾਨਿਸਤਾਨ	ಅಫ಼ಗಾನಿಸತಾನ
ਐਂਟੀਗੁਆ ਅਤੇ ਬਾਰਬੁਡਾ	ಐಂಟೀಗುಆ ಅತೇ ಬಾರಬುಡಾ
ਅੰਗੁਇਲਾ	ಅಗುಇಲಾ
ਅਲਬਾਨੀਆ	ಅಲಬಾನೀಆ
ਅਰਮੀਨੀਆ	ಅರಮೀನೀಆ
ਅੰਗੋਲਾ	ಅಗೋಲಾ
ਅੰਟਾਰਕਟਿਕਾ	ಅಟಾರಕಟಿಕಾ
ਅਰਜਨਟੀਨਾ	ಅರಜನಟೀನಾ
ਅਮੈਰੀਕਨ ਸਮੋਆ	ಅಮೈರೀಕನ ಸಮೋಆ
ਆਸਟਰੀਆ	ಆಸಟರೀಆ
ਆਸਟ੍ਰੇਲੀਆ	ಆಸಟ್ರೇಲೀಆ
ਅਰੂਬਾ	ಅರೂಬಾ
ਅਲੈਂਡ ਟਾਪੂ	ಅಲೈಂಡ ಟಾಪೂ
ਅਜ਼ਰਬਾਈਜਾਨ	ಅಜ಼ರಬಾಈಜಾನ
ਬੋਸਨੀਆ ਅਤੇ ਹਰਜ਼ੇਗੋਵੀਨਾ	ಬೋಸನೀಆ ಅತೇ ಹರಜ಼ೇಗೋವೀನಾ
ਬਾਰਬਾਡੋਸ	ಬಾರಬಾಡೋಸ
ਬੰਗਲਾਦੇਸ਼	ಬಗಲಾದೇಸ಼
ਬੈਲਜੀਅਮ	ಬೈಲಜೀಅಮ
ਬੁਰਕੀਨਾ ਫ਼ਾਸੋ	ಬುರಕೀನಾ ಫ಼ಾಸೋ
ਬੁਲਗਾਰੀਆ	ಬುಲಗಾರೀಆ
ਬਹਿਰੀਨ	ಬಹಿರೀನ
ਬੁਰੁੰਡੀ	ಬುರುಡೀ
ਬੇਨਿਨ	ಬೇನಿನ
ਸੇਂਟ ਬਾਰਥੇਲੇਮੀ	ಸೇಂಟ ಬಾರಥೇಲೇಮೀ
ਬਰਮੂਡਾ	ಬರಮೂಡಾ
ਬਰੂਨੇਈ	ಬರೂನೇಈ
ਬੋਲੀਵੀਆ	ಬೋಲೀವೀಆ
ਕੈਰੇਬੀਆਈ ਨੀਦਰਲੈਂਡ	ಕೈರೇಬೀಆಈ ನೀದರಲೈಂಡ
ਬ੍ਰਾਜ਼ੀਲ	ಬ್ರಾಜ಼ೀಲ
ਬਹਾਮਾਸ	ಬಹಾಮಾಸ
ਭੂਟਾਨ	ಭೂಟಾನ
ਬੌਵੇਟ ਟਾਪੂ	ಬೌವೇಟ ಟಾಪೂ
ਬੋਟਸਵਾਨਾ	ಬೋಟಸವಾನಾ
ਬੇਲਾਰੂਸ	ಬೇಲಾರೂಸ
ਬੇਲੀਜ਼	ಬೇಲೀಜ಼
ਕੈਨੇਡਾ	ಕೈನೇಡಾ
ਕੋਕੋਸ (ਕੀਲਿੰਗ) ਟਾਪੂ	ಕೋಕೋಸ (ಕೀಲಿಗ) ಟಾಪೂ
ਕਾਂਗੋ - ਕਿੰਸ਼ਾਸਾ	ಕಾಂಗೋ - ಕಿಸ಼ಾಸಾ
ਕਾਂਗੋ ਲੋਕਤੰਤਰੀ ਗਣਰਾਜ	ಕಾಂಗೋ ಲೋಕತತರೀ ಗಣರಾಜ
ਕੇਂਦਰੀ ਅਫ਼ਰੀਕੀ ਗਣਰਾਜ	ಕೇಂದರೀ ಅಫ಼ರೀಕೀ ಗಣರಾಜ
ਕਾਂਗੋ - ਬ੍ਰਾਜ਼ਾਵਿਲੇ	ಕಾಂಗೋ - ಬ್ರಾಜ಼ಾವಿಲೇ
ਕਾਂਗੋ ਗਣਰਾਜ	ಕಾಂಗೋ ಗಣರಾಜ
ਸਵਿਟਜ਼ਰਲੈਂਡ	ಸವಿಟಜ಼ರಲೈಂಡ
ਕੋਟ ਡੀਵੋਆਰ	ಕೋಟ ಡೀವೋಆರ
ਆਇਵਰੀ ਕੋਸਟ	ಆಇವರೀ ಕೋಸಟ
ਕੁੱਕ ਟਾਪੂ	ಕುಕ ಟಾಪೂ
ਚਿਲੀ	ಚಿಲೀ
ਕੈਮਰੂਨ	ಕೈಮರೂನ
ਚੀਨ	ಚೀನ
ਕੋਲੰਬੀਆ	ಕೋಲಬೀಆ
ਕਲਿੱਪਰਟਨ ਟਾਪੂ	ಕಲಿಪರಟನ ಟಾಪೂ
ਕੋਸਟਾ ਰੀਕਾ	ಕೋಸಟಾ ರೀಕಾ
ਕਿਊਬਾ	ಕಿಊಬಾ
ਕੇਪ ਵਰਡੇ	ಕೇಪ ವರಡೇ
ਕੁਰਾਕਾਓ	ಕುರಾಕಾಓ
ਕ੍ਰਿਸਮਿਸ ਟਾਪੂ	ಕ್ರಿಸಮಿಸ ಟಾಪೂ
ਸਾਇਪ੍ਰਸ	ಸಾಇಪ್ರಸ
ਚੈਕ ਗਣਰਾਜ	ಚೈಕ ಗಣರಾಜ
ਜਰਮਨੀ	ಜರಮನೀ
ਡੀਇਗੋ ਗਾਰਸੀਆ	ಡೀಇಗೋ ಗಾರಸೀಆ
ਜ਼ੀਬੂਤੀ	ಜ಼ೀಬೂತೀ
ਡੈਨਮਾਰਕ	ಡೈನಮಾರಕ
ਡੋਮੀਨਿਕਾ	ಡೋಮೀನಿಕಾ
ਡੋਮੀਨਿਕਾਈ ਗਣਰਾਜ	ಡೋಮೀನಿಕಾಈ ಗಣರಾಜ
ਅਲਜੀਰੀਆ	ಅಲಜೀರೀಆ
ਸਿਓਟਾ ਅਤੇ ਮੇਲਿੱਲਾ	ಸಿಓಟಾ ಅತೇ ಮೇಲಿಲಾ
ਇਕਵੇਡੋਰ	ಇಕವೇಡೋರ
ਇਸਟੋਨੀਆ	ಇಸಟೋನೀಆ
ਮਿਸਰ	ಮಿಸರ
ਪੱਛਮੀ ਸਹਾਰਾ	ಪಛಮೀ ಸಹಾರಾ
ਇਰੀਟ੍ਰਿਆ	ಇರೀಟ್ರಿಆ
ਸਪੇਨ	ಸಪೇನ
ਇਥੋਪੀਆ	ಇಥೋಪೀಆ
ਯੂਰਪੀ ਯੂਨੀਅਨ	ಯೂರಪೀ ಯೂನೀಅನ
ਫਿਨਲੈਂਡ	ಫಿನಲೈಂಡ
ਫ਼ਿਜੀ	ಫ಼ಿಜೀ
ਫ਼ਾਕਲੈਂਡ ਟਾਪੂ	ಫ಼ಾಕಲೈಂಡ ಟಾಪೂ
ਫ਼ਾਕਲੈਂਡ ਟਾਪੂ (ਆਈਲਾਸ ਮਾਲਵਿਨਾਸ)	ಫ಼ಾಕಲೈಂಡ ಟಾಪೂ (ಆಈಲಾಸ ಮಾಲವಿನಾಸ)
ਮਾਇਕ੍ਰੋਨੇਸ਼ੀਆ	ಮಾಇಕ್ರೋನೇಸ಼ೀಆ
ਫੈਰੋ ਟਾਪੂ	ಫೈರೋ ಟಾಪೂ
ਫ਼ਰਾਂਸ	ಫ಼ರಾಂಸ
ਗਬੋਨ	ಗಬೋನ
ਯੂਨਾਈਟਡ ਕਿੰਗਡਮ	ಯೂನಾಈಟಡ ಕಿಗಡಮ
ਗ੍ਰੇਨਾਡਾ	ಗ್ರೇನಾಡಾ
ਜਾਰਜੀਆ	ಜಾರಜೀಆ
ਫ਼ਰੈਂਚ ਗੁਆਨਾ	ಫ಼ರೈಂಚ ಗುಆನಾ
ਗਰਨਜੀ	ಗರನಜೀ
ਘਾਨਾ	ಘಾನಾ
ਜਿਬਰਾਲਟਰ	ಜಿಬರಾಲಟರ
ਗ੍ਰੀਨਲੈਂਡ	ಗ್ರೀನಲೈಂಡ
ਗੈਂਬੀਆ	ಗೈಂಬೀಆ
ਗਿਨੀ	ಗಿನೀ
ਗੁਆਡੇਲੋਪ	ಗುಆಡೇಲೋಪ
ਭੂ-ਖੰਡੀ ਗਿਨੀ	ಭೂ-ಖಡೀ ಗಿನೀ
ਗ੍ਰੀਸ	ಗ್ರೀಸ
ਦੱਖਣੀ ਜਾਰਜੀਆ ਅਤੇ ਦੱਖਣੀ ਸੈਂਡਵਿਚ ਟਾਪੂ	ದಖಣೀ ಜಾರಜೀಆ ಅತೇ ದಖಣೀ ಸೈಂಡವಿಚ ಟಾಪೂ
ਗੁਆਟੇਮਾਲਾ	ಗುಆಟೇಮಾಲಾ
ਗੁਆਮ	ಗುಆಮ
ਗਿਨੀ-ਬਿਸਾਉ	ಗಿನೀ-ಬಿಸಾಉ
ਗੁਯਾਨਾ	ಗುಯಾನಾ
ਹਾਂਗ ਕਾਂਗ ਐਸਏਆਰ ਚੀਨ	ಹಾಂಗ ಕಾಂಗ ಐಸಏಆರ ಚೀನ
ਹਾਂਗ ਕਾਂਗ	ಹಾಂಗ ಕಾಂಗ
ਹਰਡ ਤੇ ਮੈਕਡੋਨਾਲਡ ਟਾਪੂ	ಹರಡ ತೇ ಮೈಕಡೋನಾಲಡ ಟಾಪೂ
ਹੋਂਡੁਰਸ	ಹೋಂಡುರಸ
ਕਰੋਏਸ਼ੀਆ	ಕರೋಏಸ಼ೀಆ
ਹੈਤੀ	ಹೈತೀ
ਹੰਗਰੀ	ಹಗರೀ
ਕੇਨਾਰੀ ਟਾਪੂ	ಕೇನಾರೀ ಟಾಪೂ
ਇੰਡੋਨੇਸ਼ੀਆ	ಇಡೋನೇಸ಼ೀಆ
ਆਇਰਲੈਂਡ	ಆಇರಲೈಂಡ
ਇਜ਼ਰਾਈਲ	ಇಜ಼ರಾಈಲ
ਆਇਲ ਆਫ ਮੈਨ	ಆಇಲ ಆಫ ಮೈನ
ਭਾਰਤ	ಭಾರತ
ਬਰਤਾਨਵੀ ਹਿੰਦ ਮਹਾਂਸਾਗਰ ਪ੍ਰਦੇਸ਼	ಬರತಾನವೀ ಹಿದ ಮಹಾಂಸಾಗರ ಪ್ರದೇಸ಼
ਇਰਾਕ	ಇರಾಕ
ਈਰਾਨ	ಈರಾನ
ਆਈਸਲੈਂਡ	ಆಈಸಲೈಂಡ
ਇਟਲੀ	ಇಟಲೀ
ਜਰਸੀ	ಜರಸೀ
ਜਮਾਇਕਾ	ಜಮಾಇಕಾ
ਜਾਰਡਨ	ಜಾರಡನ
ਜਪਾਨ	ಜಪಾನ
ਕੀਨੀਆ	ಕೀನೀಆ
ਕਿਰਗਿਜ਼ਸਤਾਨ	ಕಿರಗಿಜ಼ಸತಾನ
ਕੰਬੋਡੀਆ	ಕಬೋಡೀಆ
ਕਿਰਬਾਤੀ	ಕಿರಬಾತೀ
ਕੋਮੋਰੋਸ	ಕೋಮೋರೋಸ
ਸੈਂਟ ਕਿਟਸ ਐਂਡ ਨੇਵਿਸ	ಸೈಂಟ ಕಿಟಸ ಐಂಡ ನೇವಿಸ
ਉੱਤਰੀ ਕੋਰੀਆ	ಉತರೀ ಕೋರೀಆ
ਦੱਖਣੀ ਕੋਰੀਆ	ದಖಣೀ ಕೋರೀಆ
ਕੁਵੈਤ	ಕುವೈತ
ਕੇਮੈਨ ਟਾਪੂ	ಕೇಮೈನ ಟಾಪೂ
ਕਜ਼ਾਖਸਤਾਨ	ಕಜ಼ಾಖಸತಾನ
ਲਾਓਸ	ಲಾಓಸ
ਲੈਬਨਾਨ	ಲೈಬನಾನ
ਸੇਂਟ ਲੂਸੀਆ	ಸೇಂಟ ಲೂಸೀಆ
ਲਿਚੇਂਸਟਾਇਨ	ಲಿಚೇಂಸಟಾಇನ
ਸ੍ਰੀ ਲੰਕਾ	ಸ್ರೀ ಲಕಾ
ਲਾਈਬੀਰੀਆ	ಲಾಈಬೀರೀಆ
ਲੇਸੋਥੋ	ಲೇಸೋಥೋ
ਲਿਥੁਆਨੀਆ	ಲಿಥುಆನೀಆ
ਲਕਜ਼ਮਬਰਗ	ಲಕಜ಼ಮಬರಗ
ਲਾਟਵੀਆ	ಲಾಟವೀಆ
ਲੀਬੀਆ	ಲೀಬೀಆ
ਮੋਰੱਕੋ	ಮೋರಕೋ
ਮੋਨਾਕੋ	ಮೋನಾಕೋ
ਮੋਲਡੋਵਾ	ಮೋಲಡೋವಾ
ਮੋਂਟੇਨੇਗਰੋ	ಮೋಂಟೇನೇಗರೋ
ਸੇਂਟ ਮਾਰਟਿਨ	ಸೇಂಟ ಮಾರಟಿನ
ਮੈਡਾਗਾਸਕਰ	ಮೈಡಾಗಾಸಕರ
ਮਾਰਸ਼ਲ ਟਾਪੂ	ಮಾರಸ಼ಲ ಟಾಪೂ
ਮੈਕਡੋਨੀਆ	ಮೈಕಡೋನೀಆ
ਮੈਕਡੋਨੀਆ (ਪੂਰਵ ਯੂਗੋਸਲਾਵ ਮੈਕਡੋਨੀਆਈ ਗਣਰਾਜ)	ಮೈಕಡೋನೀಆ (ಪೂರವ ಯೂಗೋಸಲಾವ ಮೈಕಡೋನೀಆಈ ಗಣರಾಜ)
ਮਾਲੀ	ಮಾಲೀ
ਮਿਆਂਮਾਰ (ਬਰਮਾ)	ಮಿಆಂಮಾರ (ಬರಮಾ)
ਮੰਗੋਲੀਆ	ಮಗೋಲೀಆ
ਮਕਾਉ ਐਸਏਆਰ ਚੀਨ	ಮಕಾಉ ಐಸಏಆರ ಚೀನ
ਮਕਾਉ	ಮಕಾಉ
ਉੱਤਰੀ ਮਾਰੀਆਨਾ ਟਾਪੂ	ಉತರೀ ಮಾರೀಆನಾ ಟಾಪೂ
ਮਾਰਟੀਨਿਕ	ಮಾರಟೀನಿಕ
ਮੋਰਿਟਾਨੀਆ	ಮೋರಿಟಾನೀಆ
ਮੋਂਟਸੇਰਾਤ	ಮೋಂಟಸೇರಾತ
ਮਾਲਟਾ	ಮಾಲಟಾ
ਮੌਰਿਸ਼ਸ	ಮೌರಿಸ಼ಸ
ਮਾਲਦੀਵ	ಮಾಲದೀವ
ਮਲਾਵੀ	ಮಲಾವೀ
ਮੈਕਸੀਕੋ	ಮೈಕಸೀಕೋ
ਮਲੇਸ਼ੀਆ	ಮಲೇಸ಼ೀಆ
ਮੋਜ਼ਾਮਬੀਕ	ಮೋಜ಼ಾಮಬೀಕ
ਨਾਮੀਬੀਆ	ನಾಮೀಬೀಆ
ਨਿਊ ਕੈਲੇਡੋਨੀਆ	ನಿಊ ಕೈಲೇಡೋನೀಆ
ਨਾਈਜਰ	ನಾಈಜರ
ਨੋਰਫੌਕ ਟਾਪੂ	ನೋರಫೌಕ ಟಾಪೂ
ਨਾਈਜੀਰੀਆ	ನಾಈಜೀರೀಆ
ਨਿਕਾਰਾਗੁਆ	ನಿಕಾರಾಗುಆ
ਨੀਦਰਲੈਂਡ	ನೀದರಲೈಂಡ
ਨਾਰਵੇ	ನಾರವೇ
ਨੇਪਾਲ	ನೇಪಾಲ
ਨਾਉਰੂ	ನಾಉರೂ
ਨਿਯੂ	ನಿಯೂ
ਨਿਊਜ਼ੀਲੈਂਡ	ನಿಊಜ಼ೀಲೈಂಡ
ਓਮਾਨ	ಓಮಾನ
ਪਨਾਮਾ	ಪನಾಮಾ
ਪੇਰੂ	ಪೇರೂ
ਫਰੈਂਚ ਪੋਲੀਨੇਸ਼ੀਆ	ಫರೈಂಚ ಪೋಲೀನೇಸ಼ೀಆ
ਪਾਪੂਆ ਨਿਊ ਗਿਨੀ	ಪಾಪೂಆ ನಿಊ ಗಿನೀ
ਫਿਲੀਪੀਂਸ	ಫಿಲೀಪೀಂಸ
ਪਾਕਿਸਤਾਨ	ಪಾಕಿಸತಾನ
ਪੋਲੈਂਡ	ಪೋಲೈಂಡ
ਸੈਂਟ ਪੀਅਰੇ ਐਂਡ ਮਿਕੇਲਨ	ಸೈಂಟ ಪೀಅರೇ ಐಂಡ ಮಿಕೇಲನ
ਪਿਟਕੇਰਨ ਟਾਪੂ	ಪಿಟಕೇರನ ಟಾಪೂ
ਪਿਊਰਟੋ ਰਿਕੋ	ಪಿಊರಟೋ ರಿಕೋ
ਫਿਲੀਸਤੀਨੀ ਖੇਤਰ	ಫಿಲೀಸತೀನೀ ಖೇತರ
ਫਿਲੀਸਤੀਨ	ಫಿಲೀಸತೀನ
ਪੁਰਤਗਾਲ	ಪುರತಗಾಲ
ਪਲਾਉ	ಪಲಾಉ
ਪੈਰਾਗਵੇ	ಪೈರಾಗವೇ
ਕਤਰ	ಕತರ
ਆਊਟਲਾਇੰਗ ਓਸ਼ੀਨੀਆ	ಆಊಟಲಾಇಗ ಓಸ಼ೀನೀಆ
ਰਿਯੂਨੀਅਨ	ರಿಯೂನೀಅನ
ਰੋਮਾਨੀਆ	ರೋಮಾನೀಆ
ਸਰਬੀਆ	ಸರಬೀಆ
ਰੂਸ	ರೂಸ
ਰਵਾਂਡਾ	ರವಾಂಡಾ
ਸਾਊਦੀ ਅਰਬ	ಸಾಊದೀ ಅರಬ
ਸੋਲੋਮਨ ਟਾਪੂ	ಸೋಲೋಮನ ಟಾಪೂ
ਸੇਸ਼ਲਸ	ಸೇಸ಼ಲಸ
ਸੂਡਾਨ	ಸೂಡಾನ
ਸਵੀਡਨ	ಸವೀಡನ
ਸਿੰਗਾਪੁਰ	ಸಿಗಾಪುರ
ਸੇਂਟ ਹੇਲੇਨਾ	ಸೇಂಟ ಹೇಲೇನಾ
ਸਲੋਵੇਨੀਆ	ಸಲೋವೇನೀಆ
ਸਵਾਲਬਰਡ ਅਤੇ ਜਾਨ ਮਾਯੇਨ	ಸವಾಲಬರಡ ಅತೇ ಜಾನ ಮಾಯೇನ
ਸਲੋਵਾਕੀਆ	ಸಲೋವಾಕೀಆ
ਸਿਏਰਾ ਲਿਓਨ	ಸಿಏರಾ ಲಿಓನ
ਸੈਨ ਮਰੀਨੋ	ಸೈನ ಮರೀನೋ
ਸੇਨੇਗਲ	ಸೇನೇಗಲ
ਸੋਮਾਲੀਆ	ಸೋಮಾಲೀಆ
ਸੂਰੀਨਾਮ	ಸೂರೀನಾಮ
ਦੱਖਣੀ ਸੂਡਾਨ	ದಖಣೀ ಸೂಡಾನ
ਸਾਓ ਟੋਮ ਅਤੇ ਪ੍ਰਿੰਸੀਪੇ	ಸಾಓ ಟೋಮ ಅತೇ ಪ್ರಿಸೀಪೇ
ਅਲ ਸਲਵਾਡੋਰ	ಅಲ ಸಲವಾಡೋರ
ਸਿੰਟ ਮਾਰਟੀਨ	ಸಿಟ ಮಾರಟೀನ
ਸੀਰੀਆ	ಸೀರೀಆ
ਸਵਾਜ਼ੀਲੈਂਡ	ಸವಾಜ಼ೀಲೈಂಡ
ਟ੍ਰਿਸਟਾਨ ਦਾ ਕੁੰਹਾ	ಟ್ರಿಸಟಾನ ದಾ ಕುಹಾ
ਟੁਰਕਸ ਅਤੇ ਕੈਕੋਸ ਟਾਪੂ	ಟುರಕಸ ಅತೇ ಕೈಕೋಸ ಟಾಪೂ
ਚਾਡ	ಚಾಡ
ਫਰੈਂਚ ਦੱਖਣੀ ਪ੍ਰਦੇਸ਼	ಫರೈಂಚ ದಖಣೀ ಪ್ರದೇಸ಼
ਟੋਗੋ	ಟೋಗೋ
ਥਾਈਲੈਂਡ	ಥಾಈಲೈಂಡ
ਤਾਜਿਕਿਸਤਾਨ	ತಾಜಿಕಿಸತಾನ
ਟੋਕੇਲਾਉ	ಟೋಕೇಲಾಉ
ਤਿਮੋਰ-ਲੇਸਤੇ	ತಿಮೋರ-ಲೇಸತೇ
ਪੂਰਬੀ ਤਿਮੋਰ	ಪೂರಬೀ ತಿಮೋರ
ਤੁਰਕਮੇਨਿਸਤਾਨ	ತುರಕಮೇನಿಸತಾನ
ਟਿਊਨੀਸ਼ੀਆ	ಟಿಊನೀಸ಼ೀಆ
ਟੌਂਗਾ	ಟೌಂಗಾ
ਤੁਰਕੀ	ತುರಕೀ
ਟ੍ਰਿਨੀਡਾਡ ਅਤੇ ਟੋਬਾਗੋ	ಟ್ರಿನೀಡಾಡ ಅತೇ ಟೋಬಾಗೋ
ਟੁਵਾਲੂ	ಟುವಾಲೂ
ਤਾਇਵਾਨ	ತಾಇವಾನ
ਤਨਜ਼ਾਨੀਆ	ತನಜ಼ಾನೀಆ
ਯੂਕਰੇਨ	ಯೂಕರೇನ
ਯੂਗਾਂਡਾ	ಯೂಗಾಂಡಾ
ਸੰਯੁਕਤ ਰਾਜ	ಸಯುಕತ ರಾಜ
ਉਰੂਗਵੇ	ಉರೂಗವೇ
ਉਜ਼ਬੇਕਿਸਤਾਨ	ಉಜ಼ಬೇಕಿಸತಾನ
ਵੈਟੀਕਨ ਸਿਟੀ	ವೈಟೀಕನ ಸಿಟೀ
ਸੇਂਟ ਵਿਨਸੈਂਟ ਐਂਡ ਗ੍ਰੇਨਾਡੀਨਸ	ಸೇಂಟ ವಿನಸೈಂಟ ಐಂಡ ಗ್ರೇನಾಡೀನಸ
ਵੇਨੇਜ਼ੂਏਲਾ	ವೇನೇಜ಼ೂಏಲಾ
ਬ੍ਰਿਟਿਸ਼ ਵਰਜਿਨ ਟਾਪੂ	ಬ್ರಿಟಿಸ಼ ವರಜಿನ ಟಾಪೂ
ਯੂ ਐਸ ਵਰਜਿਨ ਟਾਪੂ	ಯೂ ಐಸ ವರಜಿನ ಟಾಪೂ
ਵੀਅਤਨਾਮ	ವೀಅತನಾಮ
ਵਾਨੂਆਟੂ	ವಾನೂಆಟೂ
ਵਾਲਿਸ ਅਤੇ ਫੂਟੂਨਾ	ವಾಲಿಸ ಅತೇ ಫೂಟೂನಾ
ਸਾਮੋਆ	ಸಾಮೋಆ
ਕੋਸੋਵੋ	ಕೋಸೋವೋ
ਯਮਨ	ಯಮನ
ਮਾਯੋਟੀ	ಮಾಯೋಟೀ
ਦੱਖਣੀ ਅਫਰੀਕਾ	ದಖಣೀ ಅಫರೀಕಾ
ਜ਼ਾਮਬੀਆ	ಜ಼ಾಮಬೀಆ
ਜ਼ਿੰਬਾਬਵੇ	ಜ಼ಿಬಾಬವೇ
ਅਣਪਛਾਤਾ ਖੇਤਰ	ಅಣಪಛಾತಾ ಖೇತರ
