# Baby names
അകര്ശാനാ	اكرشانا
അക്ശൈനീഏ	اكشاينيي
അഗജാ	اججا
അചിംത	اتشينت
അചിത	اتشيت
അച്ചിന്ദ്ര	اتشتشيندر
അഡ്യാദവൈതാ	اديادوايتا
അദഭുതഃ	ادبهوتها
അദേന്യ	اديني
അദേല	اديل
അദ്രിതീ	ادريتي
അദ്രീഥീ	ادريتهي
അദ്രീമാം	ادريمان
അദ്വൈയാ	ادواييا
അധര്ഷ	ادهرش
അധിപാ	ادهيبا
അധീരതാ	ادهيرتا
അധ്യുത	ادهيوت
അനംതാമായാ	اننتامايا
അബരനാ	ابرنا
അബിനയ	ابيني
അബിനാ	ابينا
അബീനംദാ	ابينندا
അബീശാ	ابيشا
അഭയ	ابهي
അഭയന	ابهين
അഭിഗ്ന്യാ	ابهيجنيا
അഭിജീതാ	ابهيجيتا
അഭിനിവേശ	ابهينيويش
അഭിമ	ابهيم
അഭിമാനീ	ابهيماني
അഭിമോദാ	ابهيميادا
അഭിരാ	ابهيرا
അഭിരാത	ابهيرات
അഭീരല	ابهيرل
അഭീശ്രേയ	ابهيشريي
അഭീസുമത	ابهيسومت
അഭ്യപ്സീത	ابهيبسيت
അഭ്യുദയാ	ابهيوديا
അമൃതാ	امرتا
അലകനംദാ	الكنندا
അലക്ഷാ	الكشا
അല്കാ	الكا
അശവ	اشو
അശ്നേഇല	اشنييل
ആകാശലീനാ	آكاشلينا
ആകൃഥീ	آكرتهي
ആക്ഷ്യാ	آكشيا
ആചാര്യ	آتشاري
ആത്മയ	آتمي
ആദി	آدي
ആദിമ	آديم
ആദീവ	آديو
ആധീരേന	آدهيرين
ആധ്യാ	آدهيا
ആനംദീനീ	آننديني
ആനീകാ	آنيكا
ആന്തീകാ	آنتيكا
ആന്വീ	آنوي
ആപ്ത	آبت
ആപ്തി	آبتي
ആമാംനീ	آمانني
ആമിഷ	آميش
ആമുക്ഥാ	آموكتها
ആയുസ	آيوس
ആയോദ	آيياد
ആരംഭീ	آرنبهي
ആരതീ	آرتي
ആരസീ	آرسي
ആര്യ	آري
ആര്യക	آريك
ആര്യനാ	آرينا
ആര്യമാനീ	آريماني
ആലേഃയാ	آليهايا
ആവംശ	آونش
ആവേശ	آويش
ആശകാ	آشكا
ആശിയാനാ	آشييانا
ആശുതോഷ	آشوتياش
ആശ്മീന	آشمين
ആശ്വിത	آشويت
ആസവ	آسو
ആസ്തിക	آستيك
ഇക്ശാനാ	إكشانا
ഇജയാ	إجيا
ഇനീയന	إنيين
ഇനോദയ	إنيادي
ഇന്ദരകാന്ത	إندركانت
ഇന്ദിവാരസ	إنديوارس
ഇന്ദുശിതാലാ	إندوشيتالا
ഇന്ദ്രജാ	إندرجا
ഇന്ദ്രതന	إندرتن
ഇന്ദ്രദയുമ്ന	إندرديومن
ഇന്ദ്രവദന	إندرودن
ഇന്ദ്രാണീ	إندراني
ഇബ്ബാനീ	إبباني
ഇയുരേശ	إيوريش
ഇയേനഗര	إيينجر
ഇരാജ	إراج
ഇരിത	إريت
ഇരേശ	إريش
ഇലിസാ	إليسا
ഇശിതാ	إشيتا
ഇശ്വാര്യ	إشواري
ഇഷ്ടാ	إشطا
ഇഷ്ടി	إشطي
ഇസാര	إسار
ഇസ്ശും	إسشون
ഈതന	إتن
ഈതികാ	إتيكا
ഈരേന്പ്രിത	إرينبريت
ഈര്ശീതാ	إرشيتا
ഈലാക്കീയാ	إلاككييا
ഈലികാ	إليكا
ഈലേശാ	إليشا
ഈശാര	إشار
ഈശിക	إشيك
ഈശ്വരദത്ത	إشوردتت
ഈഹാ	إها
ഉഗ്രസ്രവാസ	وجرسرواس
ഉജവണീ	وجوني
ഉജേശാ	وجيشا
ഉജ്ജന	وججن
ഉജ്ജവല	وججول
ഉജ്ജവാലാ	وججوالا
ഉജ്ജ്വലാ /ഉജ്വലാ	وججولا /وجولا
ഉജ്ജ്വാലാ	وججوالا
ഉത്കര്ഷ	وتكرش
ഉത്കലാ	وتكلا
ഉത്തര	وتتر
ഉത്പര	وتبر
ഉത്സര്ഗ	وتسرج
ഉദയ കുമാര	ودي كومار
ഉദരഥീ	ودرتهي
ഉദാന്തികാ	ودانتيكا
ഉദേയ	وديي
ഉദ്ധാര	وددهار
ഉദ്യത	وديت
ഉദ്യമീ	وديمي
ഉദ്യോത	ودييات
ഉധവ	ودهو
ഉപംഗ	وبنج
ഉപദാ	وبدا
ഉപാധ്രീതീ	وبادهريتي
ഉപ്പാസ	وبباس
ഉമാ	وما
ഉമേശ്വര	وميشور
ഉരിശിതാ	وريشيتا
ഉര്ജാ	ورجا
ഉര്ജീകാ	ورجيكا
ഉര്ജീതാ	ورجيتا
ഉര്ദാഹാവ	ورداهاو
ഉര്മികാ	ورميكا
ഉര്മിമാലാ	ورميمالا
ഉര്വീനാഥ	ورويناته
ഉല്പേശ	ولبيش
ഉശേന്യ	وشيني
ഉഷാശി	وشاشي
ഉഷ്മാ	وشما
ഉസരീ	وسري
ഊതരാ	وترا
ഊര്വേശ	ورويش
ഏകംശീ	إيكنشي
ഏകക്ഷരപരാ	إيككشربرا
ഏകതന	إيكتن
ഏകതാ	إيكتا
ഏകാംശ	إيكانش
ഏകാകാന്യ	إيكاكاني
ഏകാനീ	إيكاني
ഏകാപര്നികാ	إيكابرنيكا
ഏകേസ്വാര	إيكيسوار
ഏത്തന	إيتتن
ഏധിത	إيدهيت
ഏമാ	إيما
ഏലനാ	إيلنا
ഏലാ	إيلا
ഏലീലവേംദന	إيليلويندن
ഏലീലീ	إيليلي
ഓഈസീന	اويسين
ഓജസ്വീ	اوجسوي
ഓജാ	اوجا
ഓജീസ	اوجيس
ഓനിശ	اونيش
ഓമപ്രകാശ	اومبركاش
ഓവീന	اووين
ഓവൈസ	اووايس
കംജ	كنج
കംജന	كنجن
കംഠന	كنطهن
കംദര്പ	كندرب
കംപനാ	كنبنا
കകോന	ككيان
കതകീ	كتكي
കതേല്യ്ന	كتيلين
കനക	كنك
കനദ	كند
കനാകംഗീ	كناكنجي
കനീജാ	كنيجا
കനീരാ	كنيرا
കനീസാ	كنيسا
കനുഷ	كنوش
കന്വക	كنوك
കന്ശീകാ	كنشيكا
കപാലീന	كبالين
കപിലാശ്വര	كبيلاشور
കമലാപതി	كملابتي
കമലിനീ	كمليني
കമലേക്ഷണ	كمليكشن
കമ്നാ	كمنا
കരാലാ	كرالا
കരീസമാം	كريسمان
കരുനാസ്രീ	كروناسري
കരുപ്പസമ്യ	كروببسمي
കര്ണ	كرن
കര്തീഗാ	كرتيجا
കര്മദീപ	كرمديب
കര്മാശ	كرماش
കലരനീ	كلرني
കലശ	كلش
കലാധര	كلادهر
കലാനിധി	كلانيدهي
കലാപരണ	كلابرن
കലാപീന	كلابين
കലാപ്രിയാ	كلابرييا
കലൈസേലവീ	كلايسيلوي
കവന	كون
കവിപ  പ്രിയ	كويب  بريي
കവീനാഥ	كويناته
കശ്തീ	كشتي
കാജല	كاجل
കാജീശ	كاجيش
കാദമ്ബരീ	كادمبري
കാധിരോലീ	كادهيريالي
കാനീ	كاني
കാന്ജീരാ	كانجيرا
കാന്തീ	كانتي
കാമത	كامت
കാമിഷാ	كاميشا
കാമേശ	كاميش
കാരുണ്യ പ്രകാശ	كاروني بركاش
കാരൂകാ	كاروكا
കാര്നിക	كارنيك
കാലിക	كاليك
കാലിപദാ	كاليبدا
കാലിയാ	كالييا
കാലീതാ	كاليتا
കാവ്യ ശ്രീ	كاوي شري
കിന്നേരാ	كيننيرا
കീഅനാ	كيانا
കീജല	كيجل
കീനാരീ	كيناري
കീന്ചനാ	كينتشنا
കേകലാ	كيكلا
കേതന	كيتن
കേനിഷാ	كينيشا
കേളവ്യ	كيروي
കൈരവീ	كايروي
കൈലാശ	كايلاش
കോശേല	كياشيل
കൌശികാ	كيشيكا
ഖഗേശ	كهجيش
ഖമീശ	كهميش
ഖാതീരാവണ	كهاتيراون
ഖാത്വന്ഗീന	كهاتونجين
ഖീലതീ	كهيلتي
ഖുസീ	كهوسي
ഗംഗാ	جنجا
ഗംദേശാ	جنديشا
ഗംധാര	جندهار
ഗംധാരാ	جندهارا
ഗംധാലീ	جندهالي
ഗഗന	ججن
ഗജവദന	ججودن
ഗജേന്ദ്ര	ججيندر
ഗണക	جنك
ഗണനാ പംഡിതന	جننا بنديتن
ഗണനാഥ	جنناته
ഗണ്യാ	جنيا
ഗതി	جتي
ഗനേസന	جنيسن
ഗന്ഗസീരുവന	جنجسيروون
ഗയാലികാ	جياليكا
ഗരിമാ	جريما
ഗരിഷ്ട	جريشط
ഗരുല	جرول
ഗാഇശ	جايش
ഗാന്ഗമൈന്ദന	جانجمايندن
ഗാമിനീ	جاميني
ഗായത്രീ	جايتري
ഗായലേ	جايلي
ഗിഅന	جيان
ഗിയാ	جييا
ഗിരിവര	جيريور
ഗീതി	جيتي
ഗീതീശാ	جيتيشا
ഗുംജാ	جونجا
ഗുനാജാ	جوناجا
ഗുനാരത്നാ	جونارتنا
ഗുനാശേകാര	جوناشيكار
ഗുനീന	جونين
ഗുന്ജീതാ	جونجيتا
ഗുപ്തക	جوبتك
ഗുരദയാല	جورديال
ഗുരദേവ	جورديو
ഗുരബാനീ	جورباني
ഗുരമാന	جورمان
ഗുരുത്തമ	جوروتتم
ഗുര്നാന്ഡീശ	جورنانديش
ഗുലമോഹര	جولمياهر
ഗുവീദ	جوويد
ഗൂംജീതാ	جونجيتا
ഗൂഹാരീ	جوهاري
ഗേനേലിയാ	جينيلييا
ഗേശനാ	جيشنا
ഗോപാല	جيابال
ഗോപീ നാഥ	جيابي ناته
ഗോഭില	جيابهيل
ഗോരഖ-നാഥ	جياركه-ناته
ഗൌരവീ	جيروي
ഗൌരീകാംത	جيريكانت
ഗൌരീശ	جيريش
ഗൌര്പ്രിയാ	جيربرييا
ഗ്രീതേശ	جريتيش
ഗ്രീവാ	جريوا
ഗ്രീശ്മീതാ	جريشميتا
ഗ്രീഷ്മ	جريشم
ഘടോതകത്ചാ	جهطياتكتتشا
ചംചലാ	تشنتشلا
ചംദേര്ഭാന	تشنديربهان
ചംദ്രകാംത	تشندركانت
ചംദ്രകാംതാ	تشندركانتا
ചംദ്രചുര	تشندرتشور
ചംദ്രപുശ്പാ	تشندربوشبا
ചംദ്രപ്രകാശ	تشندربركاش
ചംദ്രമതി	تشندرمتي
ചംദ്രലേഖാ	تشندرليكها
ചംദ്രഹാസ	تشندرهاس
ചംദ്രാനന	تشندرانن
ചംദ്രാഭാ	تشندرابها
ചംദ്രേശ	تشندريش
ചകേശ	تشكيش
ചകോര	تشكيار
ചക്ഷസ	تشكشس
ചതുര	تشتور
ചതുരാ	تشتورا
ചതുര്ഭുജാ	تشتوربهوجا
ചതുര്വേദീ	تشتورويدي
ചത്രീയാ	تشترييا
ചന്ദ്രകേതു	تشندركيتو
ചരണ	تشرن
ചരന്യാ	تشرنيا
ചലാമാ	تشلاما
ചാംദ	تشاند
ചാനാസ്യാ	تشاناسيا
ചാനേ	تشاني
ചാന്ദനികാ	تشاندنيكا
ചാരുന	تشارون
ചാരുവീ	تشارووي
ചാര്മീ	تشارمي
ചാര്വീ	تشاروي
ചാവ്രിക	تشاوريك
ചിത്കലാ	تشيتكلا
ചിത്ത	تشيتت
ചിത്തപ്രസാദ	تشيتتبرساد
ചിത്തരംജന	تشيتترنجن
ചിത്തരംജനീ	تشيتترنجني
ചിത്രകുന്ധാലാ	تشيتركوندهالا
ചിത്രകേതു	تشيتركيتو
ചിത്രഗംധാ	تشيترجندها
ചിത്രബാനാ	تشيتربانا
ചിത്രമാലാ	تشيترمالا
ചിത്രര്ത	تشيتررت
ചിത്രല	تشيترل
ചിത്രലേഖാ	تشيترليكها
ചിത്രാദീപ	تشيتراديب
ചിത്രീനീ	تشيتريني
ചിദംബര	تشيدنبر
ചിദാനംദാ	تشيدانندا
ചിനാര	تشينار
ചിന്നാദുരാഈ	تشيننادوراي
ചിമന	تشيمن
ചീദാര്ത	تشيدارت
ചീന്മയേ	تشينميي
ചീരുഷ	تشيروش
ചേതന്ദീപ	تشيتنديب
ചേതള	تشيتر
ചേഥാസാ	تشيتهاسا
ചേമ്മല	تشيممل
ചേര്വിക	تشيرويك
ചേലന	تشيلن
ചേലിയാഁ	تشيليياഁ
ചൈതന്യാ	تشايتنيا
ചൈത്രാ	تشايترا
ചൈരാവലീ	تشايراولي
ഛായാംക	تشهايانك
ജക്ഷ	جكش
ജക്ഷാനീ	جكشاني
ജഗതപ്രകാശ	ججتبركاش
ജഗദഗുരു	ججدجورو
ജഗദമ്ബാ	ججدمبا
ജഗനമോഹിനീ	ججنمياهيني
ജഗന്മയീ	ججنميي
ജഗ്വീ	ججوي
ജഗ്വീര	ججوير
ജജ്വാല്യാ	ججواليا
ജടായു	جطايو
ജനഹിതാ	جنهيتا
ജനാദേവ	جناديو
ജനാവ	جناو
ജനിത	جنيت
ജമാംദാഗ്ന്യ മഹാദാര്പാ	جمانداجني مهاداربا
ജമ്ബവതപ്രീതി	جمبوتبريتي
ജയംത	جينت
ജയചംദ	جيتشند
ജയപാല	جيبال
ജയമാലാ	جيمالا
ജയശ്രീ	جيشري
ജയാകീര്തന	جياكيرتن
ജയാകേതന	جياكيتن
ജയാപാദമാം	جيابادمان
ജയായ	جياي
ജയിത	جييت
ജയേശ	جييش
ജലദ	جلد
ജല്പേശ	جلبيش
ജശവംത	جشونت
ജസീത്താ	جسيتتا
ജസ്സീ	جسسي
ജാനകീ	جانكي
ജാനകീദാസ	جانكيداس
ജാനകീനാഥ	جانكيناته
ജാനകീഭൂഷണ	جانكيبهوشن
ജാനഹിതാ	جانهيتا
ജാപക	جابك
ജായിത്രീ	جاييتري
ജിനേശ്വര	جينيشور
ജിഹാന	جيهان
ജീതേശ	جيتيش
ജീന്ദാല	جيندال
ജീവനകലാ	جيونكلا
ജീവനീ	جيوني
ജീവന്തീനീ	جيونتيني
ജുഷ്ടി	جوشطي
ജേനീശാ	جينيشا
ജേര്ശീകാ	جيرشيكا
ജൈകാപിശ	جايكابيش
ജൈചരണ	جايتشرن
ജൈനീശ	جاينيش
ജൈപ്രകാശ	جايبركاش
ജൈവംത	جايونت
ജൈസല	جايسل
ജൈഹാസീനീ	جايهاسيني
ജോംഫീ	جيانبهي
ജോശനീകാ	جياشنيكا
ജോശീതാ	جياشيتا
ജ്വാലാ	جوالا
ജ്ഹില	جهيل
ജ്ഹീണൂക	جهينوك
ഝഹനവീ	جههنوي
ഝാനീശാ	جهانيشا
ഝാരാ	جهارا
ഝീയാ	جهييا
ഝേനീശാ	جهينيشا
ഝ്യാനനീ	جهيانني
ടീംകു	طينكو
ഠുമരീ	طهومري
തക്ശീ	تكشي
തക്ശീല	تكشيل
തജജ്ഞ	تججن
തനവീ	تنوي
തനിഷ്ക	تنيشك
തനുംജാശ്രീ	تنونجاشري
തനുംശ്കാ	تنونشكا
തനോജ	تنياج
തപസ	تبس
തപസ്വിനീ	تبسويني
തമില  സേല്വീ	تميل  سيلوي
തമിശ	تميش
തമോഘ്നാ	تمياجهنا
തമോനഷ	تميانش
തരംജോത	ترنجيات
തരനീ	ترني
തരലാ	ترلا
തരീനീ	تريني
തരുശ്രീ	تروشري
തരൂണീ	تروني
തവിഷാ	تويشا
തസ്യ	تسي
താക്ഷ്യാ	تاكشيا
താജേന്ദര	تاجيندر
താനാരുപീ	تاناروبي
താനിയാ	تانييا
താന്വീഥാ	تانويتها
താപീ	تابي
താരികാ	تاريكا
താരീനീ	تاريني
താരൂശ	تاروش
താലംക	تالنك
താലീന	تالين
താലേശ	تاليش
താവന	تاون
താവീശാ	تاويشا
തിതലീ	تيتلي
തിനാശ	تيناش
തിലക	تيلك
തീഈവ്യേശ	تييوييش
തീര്ഥാ	تيرتها
തീസ്ചാ	تيستشا
തുത്തീ	توتتي
തുനാവാ	توناوا
തുന്ഗാര	تونجار
തുപമ	توبم
തുരഗ	تورج
തുശീഥാ	توشيتها
തൃപേശ	تربيش
തേജസ	تيجس
തേജസ്വീ	تيجسوي
തേജസ്വീന	تيجسوين
തേജേനദര	تيجيندر
തേജോമയ	تيجيامي
തോയേശ	تياييش
തോശീകാ	تياشيكا
തൌരുസ	تيروس
ത്രികായാ	تريكايا
ത്രിപുരസുംദരീ	تريبورسوندري
ത്രിഭുവന	تريبهوون
ത്രിമാന	تريمان
ത്രിമൂര്തി	تريمورتي
ത്രിവേണീ	تريويني
ത്രിശല	تريشل
ത്രിശലാനാ	تريشلانا
ത്രീഝ്യാ	تريجهيا
ത്രീതിയാ	تريتييا
ത്രീനേശ	ترينيش
ത്രീപന	تريبن
ത്രീപ്ത	تريبت
ത്രീവീദ	تريويد
ത്വരിതാ	توريتا
ത്വീശീ	تويشي
ത്വേസാ	تويسا
ഥംസീ	تهنسي
ഥനീരികാ	تهنيريكا
ഥാകാപ്പന്സ്വാമീ	تهاكاببنسوامي
ഥാരികാ	تهاريكا
ഥാവനീ	تهاوني
ഥീരീശ്കാ	تهيريشكا
ഥുസീഥാ	تهوسيتها
ഥ്രേശാ	تهريشا
ദംദാപാനീ	دنداباني
ദക്ഷാഹതാ	دكشاهتا
ദബീത	دبيت
ദബ്ന്ശും	دبنشون
ദയാദാ	ديادا
ദയാനിതാ	ديانيتا
ദരഹാസ	درهاس
ദര്ശ	درش
ദര്ശക	درشك
ദര്ശികാ	درشيكا
ദര്ശീനീ	درشيني
ദര്സീകാ	درسيكا
ദശാഗ്രീവാ ശീരോഹരാ	دشاجريوا شيرياهرا
ദശാഗ്രീവാകുലാന്താകാ	دشاجريواكولانتاكا
ദശാനന	دشانن
ദഹാ	دها
ദാനാസ്വീ	داناسوي
ദാനുംശ്രീ	دانونشري
ദാന്ദാകാരാന്യ പുന്യകൃതേ	دانداكاراني بونيكرتي
ദാരുല	دارول
ദാഹക	داهك
ദികീശംദ	ديكيشند
ദിഗീശാ	ديجيشا
ദിപംശീ	ديبنشي
ദിപശീകീ	ديبشيكي
ദിപേംദര	ديبيندر
ദിപ്താ	ديبتا
ദിബസരീ	ديبسري
ദിവീഥാ	ديويتها
ദിവേനാ	ديوينا
ദീതാ	ديتا
ദീനബംധു	دينبندهو
ദീപഥീ	ديبتهي
ദീപപ്രഭാ	ديببربها
ദീപമാലാ	ديبمالا
ദീപശിഖാ	ديبشيكها
ദീപാംജലി	ديبانجلي
ദീപാശാ	ديباشا
ദീപിത	ديبيت
ദീവാംശ	ديوانش
ദേജ	ديج
ദേബജ്യോതീ	ديبجيياتي
ദേബദാത്താ	ديبداتتا
ദേബദ്രിതാ	ديبدريتا
ദേബന്ശീ	ديبنشي
ദേയ്വയാനാകാന്തന	دييوياناكانتن
ദേവഗര്ഭാ	ديوجربها
ദേവജ്യോതി	ديوجيياتي
ദേവദാന	ديودان
ദേവന്ദ്ര	ديوندر
ദേവമദാനാ	ديومدانا
ദേവരാജ	ديوراج
ദേവശ്രീ	ديوشري
ദേവാംഗനാ	ديوانجنا
ദേവാംഗീ	ديوانجي
ദേവാംശു	ديوانشو
ദേവാദീത്യാ	ديواديتيا
ദേവാനീ	ديواني
ദേവാന്ശാ	ديوانشا
ദേവാപ്രിയാ	ديوابرييا
ദേവാമനോഹാരീ	ديوامنياهاري
ദേവീന	ديوين
ദേവീലാല	ديويلال
ദേവേന	ديوين
ദേവേശീ	ديويشي
ദേവ്യഹ്നാന	ديويهنان
ദേശാവംത	ديشاونت
ദൈത്യാകുലാന്താകാ	دايتياكولانتاكا
ദൈവ്യാ	دايويا
ധക്ശീന്യ	دهكشيني
ധനസുഖ	دهنسوكه
ധനാജീ	دهناجي
ധനിഷ്ഠ	دهنيشطه
ധനു	دهنو
ധനുജാ	دهنوجا
ധനേശീ	دهنيشي
ധന്വികാ	دهنويكا
ധരമനിഷ്ഠ	دهرمنيشطه
ധരാമാം	دهرامان
ധരാഹാസീനീ	دهراهاسيني
ധരീശ	دهريش
ധര്മ  ദുത്ത	دهرم  دوتت
ധര്മഅധ്യക്ഷ	دهرمادهيكش
ധര്മദിത്യ	دهرمديتي
ധര്മദേവ	دهرمديو
ധര്ശീതാ	دهرشيتا
ധര്ശീനീ	دهرشيني
ധാമീനീ	دهاميني
ധാരാനീ	دهاراني
ധിതി	دهيتي
ധിതീ	دهيتي
ധീപ്ത്ഹാ	دهيبتها
ധീമാഹീ	دهيماهي
ധീര്ഥാ	دهيرتها
ധേയാംശീ	دهييانشي
ധൈര്യ്യാ	دهايرييا
ധ്യുഥീ	دهيوتهي
ധ്രുമീ	دهرومي
നംദക	نندك
നംദു	نندو
നക്ശ	نكش
നക്സത്രരാജാ	نكسترراجا
നഗമാനീ	نجماني
നടവര	نطور
നത്രീശാ	نتريشا
നദീപ	نديب
നഭാ	نبها
നഭോമാനീ	نبهياماني
നമന	نمن
നമനാ	نمنا
നയന	نين
നരേന്ദ്രന	نريندرن
നരേന്ദ്രനാഥ	نريندرناته
നരേശ	نريش
നവനീത വിലീപ്തംഗാ	نونيت ويليبتنجا
നവമ	نوم
നവരംഗ	نورنج
നസീബ	نسيب
നാംബീ	نانبي
നാഗനാഥ	ناجناته
നാഗപാല	ناجبال
നാഗേശ്വരണ	ناجيشورن
നാഗൈഃ	ناجايها
നാതാഭൈരവീ	ناتابهايروي
നാതിന	ناتين
നാന്ധീനീ	ناندهيني
നാന്നാന	ناننان
നാഭിതാ	نابهيتا
നാഭേംദു	نابهيندو
നാമത	نامت
നായകീ	نايكي
നായാനീ	ناياني
നായാനീകാ	نايانيكا
നാലിനികാംത	نالينيكانت
നാലീനേശയ	نالينيشي
നാവീന്യ	ناويني
നാവീല	ناويل
നാവ്യാ ദുര്ഗാ	ناويا دورجا
നാവ്രീതാ	ناوريتا
നികാരാ	نيكارا
നിഖിതാ	نيكهيتا
നിഖില	نيكهيل
നിജു	نيجو
നിധി	نيدهي
നിധിപാ	نيدهيبا
നിപാ	نيبا
നിരംജനാ	نيرنجنا
നിരമഈ	نيرمي
നിരുപമാ	نيروبما
നിര്മളാ	نيرمرا
നിര്മിതി	نيرميتي
നിലാശാ	نيلاشا
നിശാനഥീ	نيشانتهي
നീഗീഥാ	نيجيتها
നീതു	نيتو
നീഥീകാ	نيتهيكا
നീധാ	نيدها
നീധാര്സനാ	نيدهارسنا
നീമാംലന	نيمانلن
നീരാലികാ	نيراليكا
നീരൈമാംഥീ	نيرايمانتهي
നീര്മുകതാ	نيرموكتا
നീല മാധവ	نيل مادهو
നീലംജന	نيلنجن
നീലക്ഷ	نيلكش
നീല്ജാ	نيلجا
നീശാലീ	نيشالي
നീശീതീ	نيشيتي
നീശ്മീഥാ	نيشميتها
നീസ്ചീഥാ	نيستشيتها
നീഹാ	نيها
നേമീശാ	نيميشا
നേയ്സാ	نييسا
നേരീശാ	نيريشا
നൈജാ	نايجا
നൈരീതീ	نايريتي
നൈവേധീ	نايويدهي
നൌസദ	نيسد
പംകജന	بنكجن
പംചഭൂതാത്മികാ	بنتشبهوتاتميكا
പംഥീനീ	بنتهيني
പഝ്ഹേനീ	بجههيني
പത്താമ്ബരാപരീധാനാ	بتتامبرابريدهانا
പത്ര	بتر
പന്ദാലാവാസന	بندالاواسن
പമ്പാ	بمبا
പമ്ഫാ	بمبها
പയാസ	بياس
പയോധീ	بييادهي
പരംതാപാ	برنتابا
പരമാംത്മികാ	برمانتميكا
പരമാംന്ത്ര	برماننتر
പരമിലാ	برميلا
പരമേശ്വരീ	برميشوري
പരമ്വാര്ദാന	برمواردان
പരവാനീ	برواني
പരവിംദര	برويندر
പരാകാഷ	براكاش
പരാവീ	براوي
പരിഹാ	بريها
പര്തീബന	برتيبن
പര്ലീ	برلي
പര്വ	برو
പലാക്ഷ	بلاكش
പലാശീനീ	بلاشيني
പവന	بون
പവനസുത	بونسوت
പശുപതി	بشوبتي
പഹലാജ	بهلاج
പാടലാ	باطلا
പാന്ദുരംഗാ	باندورنجا
പായല	بايل
പാരു	بارو
പാര്ഥിക	بارتهيك
പാര്ഥീവീ	بارتهيوي
പാര്ഥോ	بارتهيا
പാളവീ	باروي
പാവകീ	باوكي
പാവനാ	باونا
പാവാനാ	باوانا
പാഹീ	باهي
പിവാല	بيوال
പൂജന	بوجن
പൂരതീ	بورتي
പൂരികാ	بوريكا
പൂര്വജാ	بوروجا
പൂര്വികാ	بورويكا
പേഖമ	بيكهم
പേത്ചീ	بيتتشي
പേരാരസീ	بيرارسي
പ്രകൃഥീ	بركرتهي
പ്രഗന്യാ	برجنيا
പ്രഗ്യപരാമിതാ	برجيبراميتا
പ്രജാനാ	برجانا
പ്രനാദാ	برنادا
പ്രനീധാനാ	برنيدهانا
പ്രബകരണ	بربكرن
പ്രഭാകര	بربهاكر
പ്രഭാകരന	بربهاكرن
പ്രഭാത	بربهات
പ്രഭാവ	بربهاو
പ്രാതീകാ	براتيكا
ഫനീ	بهني
ഫനീഭുഷണ	بهنيبهوشن
ഫാല്ഗുനീ	بهالجوني
ഫൂലന	بهولن
ഫ്രാന്ചീസ	بهرانتشيس
ബംദിശ	بنديش
ബംധൂല	بندهول
ബംശീ	بنشي
ബംസീധര	بنسيدهر
ബകുലാ	بكولا
ബകൂല	بكول
ബദ്രീ	بدري
ബനജ	بنج
ബനവാരീ	بنواري
ബബന	ببن
ബബിശ	ببيش
ബര്ഹന	برهن
ബലബീര	بلبير
ബഹവാസ്യ	بهواسي
ബാബു	بابو
ബാബുല	بابول
ബാല മുകുന്ദ	بال موكوند
ബാലധി	بالدهي
ബാലാമോഹന	بالامياهن
ബാലാരാജ	بالاراج
ബാലാശംകര	بالاشنكر
ബാലു	بالو
ബാലേന്ദു	باليندو
ബാസ്കാര	باسكار
ബിനീതാ	بينيتا
ബീനും	بينون
ബീന്ദുശ്രീ	بيندوشري
ബീന്നീകേര	بيننيكير
ബീപുല	بيبول
ബീബീന	بيبين
ബീരത	بيرت
ബീഹാന	بيهان
ബേനീതാ	بينيتا
ബേനും	بينون
ബേലുരമീ	بيلورمي
ബേല്ലീ	بيللي
ബൈവാവീ	بايواوي
ബൈസാഖീ	بايساكهي
ബ്രീഥ്ഹീ	بريتههي
ബ്ലേസ്സീ	بليسسي
ഭഗവാന	بهجوان
ഭദ്രക്ഷ	بهدركش
ഭദ്രനിധി	بهدرنيدهي
ഭദ്രപ്രിയാ	بهدربرييا
ഭദ്രിക	بهدريك
ഭദ്രീശാ	بهدريشا
ഭവാനീ	بهواني
ഭവ്യരാജ	بهويراج
ഭാഗവംതീ	بهاجونتي
ഭാദരന	بهادرن
ഭാനുമിത്ര	بهانوميتر
ഭാരഥീ	بهارتهي
ഭാര്ഗവന	بهارجون
ഭാര്ഗവാ	بهارجوا
ഭാര്ഘവീ	بهارجهوي
ഭാര്ദ്ദ്വാജ	بهارددواج
ഭാലേംദ്ര	بهاليندر
ഭാവതീ	بهاوتي
ഭാവീഗുരും	بهاويجورون
ഭാവ്യമ	بهاويم
ഭാശ്വീനീ	بهاشويني
ഭാസു	بهاسو
ഭാസ്കാരീ	بهاسكاري
ഭാസ്കേര	بهاسكير
ഭീമശംകര	بهيمشنكر
ഭൂദേവ	بهوديو
ഭൂപത	بهوبت
ഭൂപാല	بهوبال
ഭൂമാ	بهوما
ഭൂമാം	بهومان
ഭേരേശ	بهيريش
ഭൈരവീ	بهايروي
മംഗലമ	منجلم
മംഗേശ	منجيش
മംജു  പ്രസന്ന	منجو  برسنن
മംജുനാഥ	منجوناته
മംജുലാ	منجولا
മംത	منت
മംതോഷ	منتياش
മംദിഥാ	منديتها
മംദിരാ	منديرا
മകാലീ	مكالي
മകുര	مكور
മഗന	مجن
മണികാംത	منيكانت
മദുരാ	مدورا
മധുനിഷാ	مدهونيشا
മധുമാംലീ	مدهومانلي
മധുരിമാ	مدهوريما
മധുവംതീ	مدهوونتي
മനജീത	منجيت
മനപ	منب
മനസ്വിന	منسوين
മനാല്പ	منالب
മനീതാ	منيتا
മനീഷ	منيش
മനോജ	منياج
മനോരനജനീ	منيارنجني
മനോരിഥാ	منياريتها
മന്നത	مننت
മന്മായീ	منمايي
മല്ലികാ	ملليكا
മഹംത	مهنت
മഹാതപസ്വീ	مهاتبسوي
മഹാദുര്ഗാ	مهادورجا
മഹാദേവാ	مهاديوا
മഹാദേവാദീപുജീതാ	مهاديواديبوجيتا
മഹാന്തേശ	مهانتيش
മഹാബാലാ	مهابالا
മഹാസ്വേതാ	مهاسويتا
മഹിപതി	مهيبتي
മഹിഷാസുരമര്ദിനീ	مهيشاسورمرديني
മഹീജിത	مهيجيت
മഹേംദ്രാ	مهيندرا
മഹേശ	مهيش
മഹേശനീ	مهيشني
മഹേശീ	مهيشي
മാംതിക	مانتيك
മാംനീമോഝ്ഹീ	ماننيمياجههي
മാംനുസരീ	ماننوسري
മാംന്ക്ഷ	ماننكش
മാംന്ഗീരീ	ماننجيري
മാംന്താവ്യാഹ	ماننتاوياه
മാംന്തീകാ	ماننتيكا
മാംന്ദീതാ	ماننديتا
മാംലാമാംകാല മകാന	مانلامانكال مكان
മാഇല	مايل
മാനകാ	مانكا
മാനജ	مانج
മാനശ	مانش
മാനിക	مانيك
മാനീശീന	مانيشين
മാനോരിത	مانياريت
മാന്കന	مانكن
മാന്ദാവിക	مانداويك
മായാ	مايا
മാര്ഗശീ	مارجشي
മാര്ഗീ	مارجي
മാര്തംദ	مارتند
മാര്ഥീകാ	مارتهيكا
മാര്യ	ماري
മാര്യാ	ماريا
മാര്ഷാ	مارشا
മാലാര്കോഡീ	مالاركيادي
മാലിനീ	ماليني
മാല്ലേശാ	مالليشا
മാസൂമ	ماسوم
മാസൂമീ	ماسومي
മാഹിയാ	ماهييا
മാഹിരാജ	ماهيراج
മാഹുലീ	ماهولي
മിലീ	ميلي
മിഹീകാ	ميهيكا
മീനാ	مينا
മേധ	ميده
മേധീനീ	ميدهيني
മൈത്രായ	مايتراي
മൌലീശാ	ميليشا
മ്യ്ഥിലീ	ميتهيلي
യംശ	ينش
യക്ഷ	يكش
യജും	يجون
യജുസ	يجوس
യജ്നേശ	يجنيش
യഥാര്ഥ	يتهارته
യദുനംദന	يدونندن
യശസ്വിനീ	يشسويني
യശാശ്രീ	يشاشري
യശ്ദീപ	يشديب
യശ്മിത	يشميت
യശ്മിതാ	يشميتا
യശ്വാര്ധാനാ	يشواردهانا
യശ്വീന	يشوين
യശ്വീനീ	يشويني
യസ്വംഥ	يسونته
യാക്സീനീ	ياكسيني
യാഗ്നാകായാ	ياجناكايا
യാഗ്നീഥാ	ياجنيتها
യാചന	ياتشن
യാതീരാജു	ياتيراجو
യാദവീ	يادوي
യാദവേന്ദ്ര	يادويندر
യാന്തി	يانتي
യാശ്രീഥാ	ياشريتها
യാഷ്ക	ياشك
യാസസ്വീ	ياسسوي
യുഗന്തീകാ	يوجنتيكا
യുഗപ	يوجب
യുഗാന്ധര	يوجاندهر
യുതി	يوتي
യുവംശ	يوونش
യുവനാഥ	يووناته
യുവല	يوول
യുവാഥീ	يوواتهي
യുവാന  സൂര്യ	يووان  سوري
യുവ്നീക	يوونيك
യേര്രപ്പാ	ييررببا
യേശനാ	ييشنا
യേശാസ്വീനീ	ييشاسويني
യേസസരീ	ييسسري
യോഗദേവാ	يياجديوا
യോഗരാജ	يياجراج
യോഗാനംദ	يياجانند
യോഗിത	يياجيت
യോഗിതാ	يياجيتا
യോഗിഥ	يياجيته
യോഗേശ്വര	يياجيشور
യോഗ്ദീപ	يياجديب
യോത്ശനാ	يياتشنا
യോനേന്ദ്ര	ييانيندر
യോഹ്ശീനീ	يياهشيني
യൌവാനീ	ييواني
രംഗനാഥ	رنجناته
രംജന	رنجن
രംജികാ	رنجيكا
രംജീവ	رنجيو
രഈര്ഥ	ريرته
രക്ത	ركت
രക്തകമള	ركتكمر
രക്ഷികാ	ركشيكا
രക്ഷിത	ركشيت
രഘവാ	رجهوا
രഘവേന്ദര	رجهويندر
രഘുനാഥ	رجهوناته
രജത	رجت
രജനീശ	رجنيش
രജനേശ	رجنيش
രജീത	رجيت
രതന	رتن
രതാംജലി	رتانجلي
രതീക	رتيك
രതുല	رتول
രത്നാകര	رتناكر
രത്നാബലീ	رتنابلي
രഥനാ	رتهنا
രന്യ	رني
രന്വിഥാ	رنويتها
രബേക	ربيك
രമാംസ്വമ്യ	رمانسومي
രമ്ബേശ	رمبيش
രയാന	ريان
രര്ശ്മീതാ	ررشميتا
രവി കാന്ത	روي كانت
രവികാംത	رويكانت
രവിത	رويت
രവീജാ	رويجا
രവീനാ	روينا
രവ്യംകീ	روينكي
രശീലാ	رشيلا
രസവംത	رسونت
രസ്മീന	رسمين
രാഈ കുമാര	راي كومار
രാഖീ	راكهي
രാഗാവ	راجاو
രാഗിനീ	راجيني
രാഗേശ	راجيش
രാഗ്വേദ	راجويد
രാജക	راجك
രാജകന്യാ	راجكنيا
രാജഗോപാല	راججيابال
രാജയവര്ദന	راجيوردن
രാജാ	راجا
രാജാര്ശീ	راجارشي
രാജികാ	راجيكا
രാജീവ	راجيو
രാജേംദ്രമോഹന	راجيندرمياهن
രാജേശ്വര	راجيشور
രാജ്യശ്രീ	راجيشري
രാധാനീ	رادهاني
രാനീ	راني
രാമ  കീന്കാര	رام  كينكار
രാമഗോപാല	رامجيابال
രാമചന്ദ്രന	رامتشندرن
രാമനാരായണ	رامناراين
രാമരാ	رامرا
രാമരാജ	رامراج
രാമാംസുഗ്രീവാ	رامانسوجريوا
രാമാനംദ	رامانند
രാമാനുജമ	رامانوجم
രാമോജീ	رامياجي
രാഹിത്യ	راهيتي
രാഹീന്യ	راهيني
രാഹുലരാജ	راهولراج
രിദ്ധി	ريددهي
രീചികാ	ريتشيكا
രീതൂ	ريتو
രീഥേകാ	ريتهيكا
രീദേവ	ريديو
രീധമാം	ريدهمان
രീഭ്യാ	ريبهيا
രീശും	ريشون
രീശ്മേഥാ	ريشميتها
രേഖാ	ريكها
രേത്വിക	ريتويك
രേധാ	ريدها
രേനാ	رينا
രേനേശ	رينيش
രേമാംനീകാ	ريماننيكا
രേമീ	ريمي
രേവാതീ	ريواتي
രേവീഥാ	ريويتها
രേശമീ	ريشمي
രേശ്വീന	ريشوين
രേഹാംശീ	ريهانشي
രേഹാനാ	ريهانا
രേഹേഈലാ	ريهييلا
രേഹ്നുഘാ	ريهنوجها
രൈവത	رايوت
രൈവതാ	رايوتا
ലംഗീത	لنجيت
ലക്ഷ	لكش
ലക്ഷാകീ	لكشاكي
ലക്ഷിതാ	لكشيتا
ലക്ഷ്മീകാനതമ	لكشميكانتم
ലജ്ജാ	لججا
ലജ്ജാകാ	لججاكا
ലതാ	لتا
ലതേശ	لتيش
ലവപാല	لوبال
ലവലീന	لولين
ലഹരീ	لهري
ലാക്ശേതാ	لاكشيتا
ലാജവംതീ	لاجونتي
ലാതീശ	لاتيش
ലാനീബന	لانيبن
ലാഭാ	لابها
ലാമ്ബോധാര	لامبيادهار
ലാരീനാ	لارينا
ലാര്മികാ	لارميكا
ലാര്രാജ	لارراج
ലാര്ശന	لارشن
ലാവനീ	لاوني
ലാവിനാ	لاوينا
ലീകേശ	ليكيش
ലീത്സാ	ليتسا
ലീനാശാ	ليناشا
ലീനീത	لينيت
ലീപാക്ഷീ	ليباكشي
ലീപ്സീകാ	ليبسيكا
ലീമനാ	ليمنا
ലീലാമഈ	ليلامي
ലീശാംത	ليشانت
ലുസിയാ	لوسييا
ലേഈവീനാ	لييوينا
ലേഖീശാ	ليكهيشا
ലേമാര	ليمار
ലോകനേത്ര	لياكنيتر
ലോകാജനാനീ	لياكاجناني
ലോകാമാത്രീ	لياكاماتري
ലോകീഥാ	لياكيتها
ലോകേന്ദ്ര	لياكيندر
ലോഗീനീ	لياجيني
ലോഗേശ്വരണ	لياجيشورن
ലോചനാ	لياتشنا
ലോനാ	ليانا
ലോമാംകേശ	ليامانكيش
ലോഹിത	لياهيت
ലോഹിതാശ്വാ	لياهيتاشوا
ലൌക്യ	ليكي
വംദിതാ	ونديتا
വംസികൃഷ്ണ	ونسيكرشن
വനദ	وند
വനമാംഥീ	ونمانتهي
വനസ	ونس
വനിനാധ	ونيناده
വന്ജുല	ونجول
വപുസ	وبوس
വയദീശ	ويديش
വരലീ	ورلي
വരിന	ورين
വരിയാസ	وريياس
വരുന	ورون
വരുനികാ	ورونيكا
വര്ണിത	ورنيت
വര്ധമാന	وردهمان
വര്ധാനീ	وردهاني
വര്ധീമൈനകാപുജീതാ	وردهيماينكابوجيتا
വര്നീശാ	ورنيشا
വര്ശനേയാ	ورشنييا
വര്ശീകാ	ورشيكا
വര്ശീതാ	ورشيتا
വര്ശീദ	ورشيد
വര്ഷനീ	ورشني
വല്ലികാ	ولليكا
വസംതാ	وسنتا
വസംതീ	وسنتي
വസീസതാ	وسيستا
വസുമിത്ര	وسوميتر
വസുസേന	وسوسين
വാക്പതി	واكبتي
വാക്ഷു	واكشو
വാച്യ	واتشي
വാജ്രക്ഷ	واجركش
വാതത്മാജ	واتتماج
വാത്സല്യ	واتسلي
വാദിവേലും	واديويلون
വാനര	وانر
വാന്ശുല	وانشول
വാമന	وامن
വാമാംക്ഷീ	وامانكشي
വാമീല	واميل
വാരനാ	وارنا
വാരുനീ	واروني
വാലാരമാംഥീ	والارمانتهي
വാല്ല്മാംനാലന	واللماننالن
വാശു	واشو
വാസുമന	واسومن
വാഹിനീ	واهيني
വികീശാ	ويكيشا
വിക്ഷിത	ويكشيت
വിജയാലക്ഷ്മീ	ويجيالكشمي
വിജയാശാനഥീ	ويجياشانتهي
വിജീതാ	ويجيتا
വിദിശാ	ويديشا
വിദ്യാ	ويديا
വിദ്യുല	ويديول
വിധാഥരീ	ويدهاتهري
വിന്ധുജാ	ويندهوجا
വിബാലീ	ويبالي
വിഭാവാ	ويبهاوا
വിഭൂതി	ويبهوتي
വിഭൂഷ	ويبهوش
വിയാമര്ശ	وييامرش
വിരഗനാപതീ	ويرجنابتي
വിരഭാദ്രപ്പാ	ويربهادرببا
വിരാജ	ويراج
വിലാശീനീ	ويلاشيني
വീണാ	وينا
വീണാധാരീ	وينادهاري
വേക്രാംത	ويكرانت
വേഗ	ويج
വേഗവാഹീനീ	ويجواهيني
വേഗീ	ويجي
വേണു	وينو
വേത്ത്രീ	ويتتري
വേത്രിവാല	ويتريوال
വേത്രീവേല	ويتريويل
വേദകാര്തിക	ويدكارتيك
വേദവല്ലീ	ويدوللي
വേദാ	ويدا
വേദാ ശ്രീ	ويدا شري
വേധാംത	ويدهانت
വേന്കാത്രമണ	وينكاترمن
വേന്തന	وينتن
വേന്നേലാ	ويننيلا
വേന്മതീ	وينمتي
വേലു	ويلو
വേഹംത	ويهنت
വൈകുംഠ	وايكونطه
വൈജീനാഥ	وايجيناته
വൈദത	وايدت
വൈദേഹീ	وايديهي
വൈദ്യുംത	وايديونت
വൈധേ	وايدهي
വൈധ്യാത	وايدهيات
വൈരാഗ	وايراج
വൈരോചന	وايرياتشن
വൈശാലീ	وايشالي
വൈശ്വീ	وايشوي
വൈഷ്ണവീ	وايشنوي
വൈസകാ	وايسكا
സംക്രാംതി	سنكرانتي
സംഗമിത്ര	سنجميتر
സംഗമീധീരാ	سنجميدهيرا
സംചയ	سنتشي
സംചീതീ	سنتشيتي
സംജേനാ	سنجينا
സംജോലീ	سنجيالي
സംതോക	سنتياك
സംദിപോന	سنديبيان
സംദീപ	سنديب
സംദേശ	سنديش
സംധരാ	سندهرا
സംധ്യാ	سندهيا
സംബീതാ	سنبيتا
സംമീതാ	سنميتا
സംയുക്ത	سنيوكت
സംവിധാ	سنويدها
സംവീഥാ	سنويتها
സംസ്കൃതി	سنسكرتي
സംഹിത	سنهيت
സക്ശീന്യാ	سكشينيا
സഖ്യാ	سكهيا
സഗന	سجن
സഗുനാ	سجونا
സചിതാ	ستشيتا
സചിദാനംദ വിഗ്രഹ	ستشيدانند ويجره
സചേതന	ستشيتن
സച്ചിദാനംദാ	ستشتشيدانندا
സജീത	سجيت
സജീലീ	سجيلي
സദഗതി	سدجتي
സദഗുനാ	سدجونا
സദാശിവ	سداشيو
സദിശ	سديش
സപനാ	سبنا
സപുഷ്പാ	سبوشبا
സപ്താബീ	سبتابي
സപ്തോര്ശീ	سبتيارشي
സമജാ	سمجا
സമദര്ശീ	سمدرشي
സമഭ്ദ്ധാ	سمبهددها
സമരേശ	سمريش
സമാംദ്രിതാ	سماندريتا
സമാംര്ധ	سمانرده
സമാജസ	سماجس
സമാരാസ്യാ	سماراسيا
സമിക	سميك
സമിരന	سميرن
സമേംദ്ര	سميندر
സമേശ	سميش
സമ്പൂര്ണ	سمبورن
സമ്പ്രഥ്യ	سمبرتهي
സമ്പ്രീതീ	سمبريتي
സമ്രാട	سمراط
സമ്രീധ	سمريده
സരസംഗീ	سرسنجي
സലീജ	سليج
സഹര്സീതാ	سهرسيتا
സഹശ്രദ	سهشرد
സഹസ്ത്രജീത	سهسترجيت
സഹസ്ത്രബാഹു	سهسترباهو
സഹീത	سهيت
സഹീരാമ	سهيرام
സഹ്യ	سهي
സാംജ	سانج
സാഇ രാമ	ساي رام
സാഈനാഥ	سايناته
സാചീ	ساتشي
സാജന	ساجن
സാദ്രീശീ	سادريشي
സാദ്വിഥാ	سادويتها
സാധന	سادهن
സാധ്യാ	سادهيا
സാനിധ്യ	سانيدهي
സാമംതാ	سامنتا
സാമ്ഭാ	سامبها
സാരണീ	سارني
സാരഥീ	سارتهي
സാരികാ	ساريكا
സാലവീ	سالوي
സാലസാ	سالسا
സൈകത	سايكت
സൈനീത്യ	ساينيتي
സൈന്ധന്യ	سايندهني
സൈലീ	سايلي
സൈഹാര്സന	سايهارسن
ഹംസമാലാ	هنسمالا
ഹംസാവാഥ്യ	هنساواتهي
ഹനാര്വീന	هناروين
ഹനീതാ	هنيتا
ഹനുപ	هنوب
ഹനുമാന	هنومان
ഹബീതാ	هبيتا
ഹമസാദീപികാ	همساديبيكا
ഹമസാനംദീനീ	همساننديني
ഹമീര	همير
ഹരജീത	هرجيت
ഹരജീവന	هرجيون
ഹരനാധ	هرناده
ഹരശും	هرشون
ഹരികിശന	هريكيشن
ഹരിഗംഗാ	هريجنجا
ഹരിഗോപാല	هريجيابال
ഹരിദാസ	هريداس
ഹരിദ്വാര	هريدوار
ഹരിപ്രീത	هريبريت
ഹരിമംതീ	هريمنتي
ഹരീ	هري
ഹരേശ്വര	هريشور
ഹര്മീന	هرمين
ഹര്ഷണ	هرشن
ഹര്സികാ	هرسيكا
ഹശ്മീതാ	هشميتا
ഹസമുഖ	هسموكه
ഹസീതാ	هسيتا
ഹസ്വീഥാ	هسويتها
ഹാര്ദീനീ	هارديني
ഹാര്ശീനീ	هارشيني
ഹാലിക	هاليك
ഹിംഡോള	هينديار
ഹിംദോലാ	هينديالا
ഹിതാക്ഷീ	هيتاكشي
ഹിതീ	هيتي
ഹിഥീക്സാ	هيتهيكسا
ഹിമാംശു	هيمانشو
ഹിമാക്ഷ	هيماكش
ഹിമാലയ	هيمالي
ഹിരംയക	هيرنيك
ഹിരവ	هيرو
ഹിരവാ	هيروا
ഹിരുധായാ	هيرودهايا
ഹിവാ	هيوا
ഹീരാനമാം	هيرانمان
ഹീരാന്യാപ്രകാഈ	هيرانيابركاي
ഹീര്നാക്ഷീ	هيرناكشي
ഹുവീശ്കാ	هوويشكا
ഹൃദയനാഥ	هرديناته
ഹേഈദീ	هييدي
ഹേജല	هيجل
ഹേതാ	هيتا
ഹേതാശ	هيتاش
ഹേത്ശ്രീ	هيتشري
ഹേഥാന്ശ്രീ	هيتهانشري
ഹേനീത	هينيت
ഹേനീല	هينيل
ഹേമനാഥ	هيمناته
ഹേമലതാ	هيملتا
ഹേമാ	هيما
ഹേമാംദ്രികാ	هيماندريكا
ഹേമാഗൌരീ	هيماجيري
ഹേമാനംദ	هيمانند
ഹേമാലാ	هيمالا
ഹേമാവതീ	هيماوتي
ഹേമാവാതിനംദന	هيماواتينندن
ഹേമേംദു	هيميندو
ഹേയന	هيين
ഹേയാംശ	هييانش
ഹേരീത	هيريت
ഹേലീ	هيلي
ഹോന്നേശാ	هياننيشا
ഹോമാ	هياما
ഹ്രീത്വിക	هريتويك
ഹ്രീദാന്ക്ഷ	هريدانكش
ഹ്രീധാന	هريدهان
ഹ്രീശന	هريشن
ഹ്രീശാംത	هريشانت
ഹ്രീഷിത	هريشيت
ഹ്രുദയ	هرودي
ഹ്രുശാല	هروشال
ഹ്രേയാംശ	هرييانش
ഹ്ര്യ്ദയേശ	هريدييش
