# Baby names
ਅਂਗਦ	انگد
ਅਂਗਦ ਦੇਵ	انگد دیو
ਅਂਗਾਰਿਕਾ	انگاریکا
ਅਂਤਰਜੋਤ	انترجوت
ਅਂਤਰਪ੍ਰਿਤ	انترپریت
ਅਂਤਰਾ	انترا
ਅਕਲਤਟ	اکلتٹ
ਅਕਲਰੂਪ	اکلروپ
ਅਕਲਸ਼ਰਣ	اکلسرن
ਅਕਲਸੀਮਾਰ	اکلسیمار
ਅਕਾਲਜੋਗ	اکالجوگ
ਅਕਾਲਦੀਪ	اکالدیپ
ਅਕਾਲਪ੍ਰੀਤ	اکالپریت
ਅਕਾਲਬੀਰ	اکالبیر
ਅਗਮਜੀਤ	اگمجیت
ਅਗਮਜੋਤ	اگمجوت
ਅਗਮ੍ਪਾਲ	اگمپال
ਅਗਮ੍ਪ੍ਰੀਤ	اگمپریت
ਅਜ੍ਮੀਨ੍ਦੇਰ	اجمیندیر
ਅਝਾਦਬੀਰ	اجھادبیر
ਅਝੀਝ	اجھیجھ
ਅਤੀਨਦੇਰ੍ਜਿਤ	اتیندیرجیت
ਅਤੀਨ੍ਦੇਰ	اتیندیر
ਅਤ੍ਤਾਮਜਿਤ	اتتامجیت
ਅਨਂਤਦੇਵ	اننتدیو
ਅਨਂਤਰ	اننتر
ਅਨਂਤਵੀਰ	اننتویر
ਅਨਂਤ੍ਜੀਤ	اننتجیت
ਅਨਾਹਤ	اناهت
ਅਨਿਂਦਿਤਾ	انیندیتا
ਅਨਿਸ਼ਾ	انیسا
ਅਨੀਲਜੋਤ	انیلجوت
ਅਨੀਸ਼੍ਕੋਉਂਰ	انیسکوونر
ਅਨੁਂਜਪਾਲ	انونجپال
ਅਨੁਂਪਜੋਤ	انونپجوت
ਅਨੁਰਾਧਾ	انورادھا
ਅਨੁਸ਼੍ਕਾ	انوسکا
ਅਨੂਪਜੋਤ	انوپجوت
ਅਨੂਪਬੀਰ	انوپبیر
ਅਨੂਪਲੋਕ	انوپلوک
ਅਪੂਰ੍ਵਾ	اپوروا
ਅਪ੍ਰੀਨਦੇਰ	اپریندیر
ਅਬਨੀ	ابنی
ਅਬਿਚਾਲ	ابیچال
ਅਬਿਨਾਸ਼	ابیناس
ਅਭਿਜੀਤ	ابھیجیت
ਅਭਿਰੂਪ	ابھیروپ
ਅਮਨਜੀਤ	امنجیت
ਅਮਰਜੋਤ	امرجوت
ਅਮਰਤ	امرت
ਅਮਰਿਂਦਰ	امریندر
ਅਮਰਿਤ	امریت
ਅਮਲਜੋਤ	املجوت
ਅਮਾਨਜੀਵਨ	امانجیون
ਅਮਾਨੀਨ੍ਦੇਰ	امانیندیر
ਅਮਾਨ੍ਰੂਪ	امانروپ
ਅਮਾਰ੍ਪਾਲ	امارپال
ਅਮਾਰ੍ਬੀਰ	اماربیر
ਅਮਿਕ	امیک
ਅਮਿਤ	امیت
ਅਮਿਤੋਜ	امیتوج
ਅਮੀਤਪਾਲ	امیتپال
ਅਮੀਤ੍ਬੀਰ	امیتبیر
ਅਮੋਲ੍ਰਸ	امولرس
ਅਮ੍ਨੀਨ੍ਦੇਰ	امنیندیر
ਅਮ੍ਰੀਤਬਾਨ	امریتبان
ਅਮ੍ਰੀਤ੍ਪ੍ਰਿਤ	امریتپریت
ਅਮ੍ਰੀਤ੍ਵਾਨੀ	امریتوانی
ਅਰਮਾਨੀ	ارمانی
ਅਰਵਜੋਤ	اروجوت
ਅਰੀਨਾਜੇਤ	اریناجیت
ਅਰੀਨ੍ਦੇਰ੍ਜੀਤ	اریندیرجیت
ਅਰੁਨਜੀਤ	ارونجیت
ਅਰੁਨਜੋਤ	ارونجوت
ਅਰ੍ਚਨਾ	ارچنا
ਅਰ੍ਦਮਨ	اردمن
ਅਰ੍ਨਾਲੀਨ੍ਦੇਰ	ارنالیندیر
ਅਰ੍ਸ਼੍ਦੀਪ	ارسدیپ
ਅਲੋਕ੍ਪਾਲ	الوکپال
ਅਲ੍ਪਨਾ	الپنا
ਅਵਨੀਨਦੇਰ	اونیندیر
ਅਵਿਰ	اویر
ਅਵ੍ਲੀਨ	اولین
ਅਸਂਖ	اسنکھ
ਅਸ਼ਮਿਤ	اسمیت
ਅਸ਼ਰ੍ਨਾਮ	اسرنام
ਅਸ਼ਰ੍ਪ੍ਰੀਤ	اسرپریت
ਅਸ਼ਰ੍ਪ੍ਰੇਮ	اسرپریم
ਅਸ਼ਰ੍ਵੀਰ	اسرویر
ਅਸ਼ਿਮਾ	اسیما
ਅਸੀਮ	اسیم
ਅਸੀਸ	اسیس
ਅਸ੍ਨੇਹ	اسنیه
ਆਖਰੀ	آکھری
ਆਤ੍ਮਜਾ	آتمجا
ਆਨਂਦਮਯੀ	آنندمیی
ਆਨਂਦਰੂਪ	آنندروپ
ਆਯਕਾਰ	آیکار
ਆਯਾਤਪ੍ਰਿਤ	آیاتپریت
ਆਯੁਸ਼੍ਮਤਿ	آیوسمتی
ਆਰਮਾਨ	آرمان
ਆਰਾਧ	آرادھ
ਆਰਾਧਨਾ	آرادھنا
ਆਰ੍ਯਨ	آرین
ਇਂਦਰਬੀਰ	اِندربیر
ਇਂਦਿਵਰ	اِندیور
ਇਕਪ੍ਰਿਤ	اِکپریت
ਇਕਬਾਲ	اِکبال
ਇਕਰੂਪ	اِکروپ
ਇਕ੍ਪੂਜ	اِکپوج
ਇਕ੍ਮਾਨ	اِکمان
ਇਚ੍ਕਜਿਤ	اِچکجیت
ਇਨ੍ਦਾਰਤੇਜ	اِندارتیج
ਇਨ੍ਦਾਰਮਿਤ	اِندارمیت
ਇਨ੍ਦਾਰ੍ਦੀਪ	اِنداردیپ
ਇਨ੍ਦਾਰ੍ਪ੍ਰਿਤ	اِندارپریت
ਇਨ੍ਦਾਰ੍ਪ੍ਰੇਮ	اِندارپریم
ਇਨ੍ਦੇਰ	اِندیر
ਇਨ੍ਦੇਰਪਲ	اِندیرپل
ਇਨ੍ਦੇਰਮਾਨ	اِندیرمان
ਇਨ੍ਦੇਰਹਾਰ੍ਜਿਤ	اِندیرهارجیت
ਇਮਰਾਤ	اِمرات
ਈਖ੍ਤਿਅਰ	اِکھتیار
ਈਨ੍ਦਰ੍ਜੀਏਤ	اِندرجییت
ਈਨ੍ਦੇਰਤੇਕ	اِندیرتیک
ਈਨ੍ਦੇਰਵੀਰ	اِندیرویر
ਈਬਾਦਤ	اِبادت
ਈਸ਼ਪਾਲ	اِسپال
ਈਸ਼ਲੀਨ	اِسلین
ਈਸ਼ਾਰਤੇਕ	اِسارتیک
ਈਸ਼ਾਰਪਾਲ	اِسارپال
ਈਸ਼੍ਤ੍ਵਰ੍ਜਿਤ	اِستورجیت
ਈਸ਼੍ਪ੍ਰਿਤ	اِسپریت
ਈਸ਼੍ਵਾਰ੍ਜਿਤ	اِسوارجیت
ਈਸ਼੍ਵੀਨਦੇਰ	اِسویندیر
ਉਖ੍ਤਿਅਰ	وکھتیار
ਉਚਪਾਲ	وچپال
ਉਚਪ੍ਰਿਤ	وچپریت
ਉਚੀਤਦੀਪ	وچیتدیپ
ਉਚੀਤਪ੍ਰਿਤ	وچیتپریت
ਉਚੀਤਬੀਰ	وچیتبیر
ਉਚੀਤਰੂਪ	وچیتروپ
ਉਚੀਤਲੋਕ	وچیتلوک
ਉਚੀਤਵਂਤ	وچیتونت
ਉਜਗਰ੍ਜੋਤ	وجگرجوت
ਉਜਗਰ੍ਦੀਪ	وجگردیپ
ਉਜਗਰ੍ਬੀਰ	وجگربیر
ਉਜਾਗਰ	وجاگر
ਉਜਾਲਾ	وجالا
ਉਜ੍ਜਲਜੋਤ	وججلجوت
ਉਤ੍ਤਮ	وتتم
ਉਤ੍ਤਮਪਾਲ	وتتمپال
ਉਤ੍ਤਮਲੀਵ	وتتملیو
ਉਤ੍ਤਾਮਕਾਰਾਮ	وتتامکارام
ਉਤ੍ਤਾਮਜੋਧ	وتتامجودھ
ਉਤ੍ਤਾਮਤਿਰਥ	وتتامتیرتھ
ਉਤ੍ਤਾਮਤੇਕ	وتتامتیک
ਉਤ੍ਤਾਮਦੀਪ	وتتامدیپ
ਉਤ੍ਤਾਮਪਦ	وتتامپد
ਉਤ੍ਤਾਮ੍ਰਸ	وتتامرس
ਉਤ੍ਤਾਮ੍ਰੂਪ	وتتامروپ
ਉਤ੍ਰਕ੍ਸ਼	وترکس
ਉਦੀਤਦੀਪ	ودیتدیپ
ਉਦੀਤਪ੍ਰਿਤ	ودیتپریت
ਉਦੀਤਬੀਰ	ودیتبیر
ਉਦੈਬੀਰ	ودایبیر
ਉਦੈਭਗਤ	ودایبھگت
ਉਦ੍ਦਾਮਜੀਤ	وددامجیت
ਉਪਕਰਮ	وپکرم
ਉਪਕਿਰਤ	وپکیرت
ਉਪਜਿਤ	وپجیت
ਉਪਨਿਤ	وپنیت
ਉਪੀਨਦੇਰ੍ਪ੍ਰਿਤ	وپیندیرپریت
ਉਪੇਨ੍ਦੇਰ	وپیندیر
ਉਮੀਦ	ومید
ਊਤ੍ਤਮ੍ਗਿਆਨ	وتتمگیآن
ਏਕਂਕਰ	یکنکر
ਏਕਬੀਰ	یکبیر
ਏਕਮ	یکم
ਏਕਮਪੂਜ	یکمپوج
ਏਕਮਬੀਰ	یکمبیر
ਏਕਮ੍ਜੋਤ	یکمجوت
ਏਕਮ੍ਰੂਪ	یکمروپ
ਏਕਾਨਪ੍ਰੀਤ	یکانپریت
ਏਕ੍ਕਾਮ	یککام
ਏਤੀਬਾਰ	یتیبار
ਏਤ੍ਤਲੀਨ	یتتلین
ਏਰਸ਼ੀਨ	یرسین
ਏਵੇਨਿਤ	یوینیت
ਏਸ਼ਨਾ	یسنا
ਏਸ਼੍ਵਰ	یسور
ਓਨਕਾਰ੍ਜਿਤ	اونکارجیت
ਓਨਕਾਰ੍ਜੀਤ	اونکارجیت
ਓਨਕਾਰ੍ਪ੍ਰਿਤ	اونکارپریت
ਓਮਪ੍ਰਿਤ	اومپریت
ਕਂਵਲ	کنول
ਕਂਵਲਜੀਤ	کنولجیت
ਕਨਵਾਰ੍ਜਾਗਤ	کنوارجاگت
ਕਨਵਾਰ੍ਜਿਤ	کنوارجیت
ਕਨਵਾਰ੍ਪ੍ਰੇਮ	کنوارپریم
ਕਨਵਾਲ੍ਜੋਤ	کنوالجوت
ਕਨਵਾਲ੍ਨੈਨ	کنوالناین
ਕਨਵਾਲ੍ਪਾਲ	کنوالپال
ਕਨਵਾਲ੍ਪ੍ਰੇਮ	کنوالپریم
ਕਨਵਾਲ੍ਬੀਰ	کنوالبیر
ਕਨਵਾਲ੍ਰੂਪ	کنوالروپ
ਕਨ੍ਚਨ੍ਦੀਪ	کنچندیپ
ਕਨ੍ਚਾਨ੍ਪਾਲ	کنچانپال
ਕਨ੍ਵਾਰਪਾਲ	کنوارپال
ਕਮਾਲ੍ਲਾ	کماللا
ਕਰਨਦੀਪ	کرندیپ
ਕਰਨਪਾਲ	کرنپال
ਕਰਨਪ੍ਰਿਤ	کرنپریت
ਕਰਨਰੂਪ	کرنروپ
ਕਰਮਪਲ	کرمپل
ਕਰਮਪੁਲ	کرمپول
ਕਰਮ੍ਜੋਤ	کرمجوت
ਕਰੁਨ੍ਯਾ	کرونیا
ਕਲਬੀਰ	کلبیر
ਕਲਾਜੋਤ	کلاجوت
ਕਲਾਪ੍ਰੇਮ	کلاپریم
ਕਵਨਿਤ	کونیت
ਕਵਨੀਰ	کونیر
ਕਵਾਲ੍ਨਾਨ	کوالنان
ਕਵਿਰਾਜ	کویراج
ਕਸਮ	کسم
ਕਾਨਵਾਲੀਨ੍ਦੇਰ	کانوالیندیر
ਕਾਮਾਂਲਜੋਤ	کامانلجوت
ਕਾਮਾਂਲਮਿਤ	کامانلمیت
ਕਾਮਾਂਲਮੋਹਨ	کامانلموهن
ਕਾਮਾਂਲ੍ਪਤਿ	کامانلپتی
ਕਾਰਮਨ	کارمن
ਕਾਵਾਲਪ੍ਰਿਤ	کاوالپریت
ਕਿਰਣਜੀਤ	کیرنجیت
ਕਿਰਨਰੂਪ	کیرنروپ
ਕਿਰਨਸੁਖ	کیرنسوکھ
ਕਿਸ਼ੇਨ	کیسین
ਕੁਂਵਰਜੀਤ	کونورجیت
ਕੁਲ	کول
ਕੁਲਜੋਤ	کولجوت
ਕੁਲਮਿਤ	کولمیت
ਕੁਲਰਾਤਨ	کولراتن
ਕੁਲਰੂਪ	کولروپ
ਕੁਲਵਂਠ	کولونٹھ
ਕੁਸ਼ਪ੍ਰਿਤ	کوسپریت
ਕੇਵਾਲਦੀਪ	کیوالدیپ
ਕੇਵਾਲਬੀਰ	کیوالبیر
ਕੋਉਰ	کوور
ਕੋਮਾਂਲਜੀਤ	کومانلجیت
ਕੋਮਾਂਲਪ੍ਰੇਮ	کومانلپریم
ਕੋਮਾਲਦੀਪ	کومالدیپ
ਕੋਮਾਲਮਿਤ	کومالمیت
ਕੌਰ	کاور
ਕ੍ਰਿਸ਼੍ਦੀਪ	کریسدیپ
ਕ੍ਸ਼ਾਗਨ	کساگن
ਕ੍ਸ਼ਾਗਰ	کساگر
ਕ੍ਸ਼ਿਤਿਜ	کسیتیج
ਕ੍ਸ਼੍ਹੀਮ	کسهیم
ਖਰਗ	کھرگ
ਖਾਲਾਕ੍ਵੀਰ	کھالاکویر
ਖੁਂਸ਼ਜੋਤ	کھونسجوت
ਖੁਸ	کھوس
ਖੁਸ਼	کھوس
ਖੁਸ਼ਜੀਤ	کھوسجیت
ਖੇਮਵਂਤ	کھیمونت
ਗਗਨ	گگن
ਗਗਨਜੀਵ	گگنجیو
ਗਗਨਜੋਤ	گگنجوت
ਗਗਨਪ੍ਰਿਤ	گگنپریت
ਗਗਨਮਿਤ	گگنمیت
ਗਤਲੀਨ	گتلین
ਗਤਸ਼ਰਣ	گتسرن
ਗਤਸੀਮਾਰ	گتسیمار
ਗਰੀਨ੍ਦੇਰ	گریندیر
ਗਰ੍ਗੋਤ	گرگوت
ਗਾਤਨੀਵਾਸ	گاتنیواس
ਗਿਅਨ	گیان
ਗੀਂਜੀਵਨ	گینجیون
ਗੀਂਰਾਤਨ	گینراتن
ਗੀਂਲੀਨ	گینلین
ਗੀਅਂਗੀਤ	گیانگیت
ਗੀਅਂਚੇਤਨ	گیانچیتن
ਗੀਅਂਜੋਤ	گیانجوت
ਗੀਅਂਪ੍ਰਿਤ	گیانپریت
ਗੀਅਂਰੂਪ	گیانروپ
ਗੀਅਨੀਨਦੇਰ	گیانیندیر
ਗੀਅਨ੍ਬੀਰ	گیانبیر
ਗੀਆਨਪ੍ਰਿਤ	گیآنپریت
ਗੀਆਨਲੀਨ	گیآنلین
ਗੀਤ	گیت
ਗੀਤਲੀਨ	گیتلین
ਗੀਤੀਨਦੇਰ	گیتیندیر
ਗੁਣਿਤ	گونیت
ਗੁਨ ਦਾਤ	گون دات
ਗੁਨਕਿਰਤ	گونکیرت
ਗੁਨਜਸ	گونجس
ਗੁਨਜਿਤ	گونجیت
ਗੁਨਜੀਵਨ	گونجیون
ਗੁਨਜੁਨ	گونجون
ਗੁਨਜੋਤ	گونجوت
ਗੁਨਪ੍ਰਿਤ	گونپریت
ਗੁਨਮਿਤ	گونمیت
ਗੁਨਰਾਜ	گونراج
ਗੁਨਸ਼ਾਂਤ	گونسانت
ਗੁਨਾਤਮ	گوناتم
ਗੁਨਿਤਪੁਲ	گونیتپول
ਗੁਨਿਤਪ੍ਰਿਤ	گونیتپریت
ਗੁਨ੍ਰਿਤ	گونریت
ਗੁਰਕਮਲ਼	گورکمل
ਗੁਰਗਿਯਨ	گورگیین
ਗੁਰਜਾਸ	گورجاس
ਗੁਰਜੀਵਨ	گورجیون
ਗੁਰਜੋਗ	گورجوگ
ਗੁਰਜੋਤ	گورجوت
ਗੁਰਝੀਲ	گورجھیل
ਗੁਰਤਰਣ	گورترن
ਗੁਰਤਿਰਥ	گورتیرتھ
ਗੁਰਦਰ੍ਸ਼ਨ	گوردرسن
ਗੁਰਦਿਤ	گوردیت
ਗੁਰਦੀਤ੍ਤਾ	گوردیتتا
ਗੁਰਦ੍ਵੀਪ	گوردویپ
ਗੁਰਨਾਦ	گورناد
ਗੁਰਨਾਮਾਸ੍ਕਾਰ	گورناماسکار
ਗੁਰਨੀਧ	گورنیدھ
ਗੁਰਨੀਰ੍ਮਾਲ	گورنیرمال
ਗੁਰਨੀਸ਼ਾਨ	گورنیسان
ਗੁਰਨ੍ਯਮ	گورنیم
ਗੁਰਪਰ੍ਵਿਨ	گورپروین
ਗੁਰਪੀਨਦੇਰ	گورپیندیر
ਗੁਰਪ੍ਰੀਤਮ	گورپریتم
ਗੁਰਬਕ੍ਸ਼	گوربکس
ਗੁਰਬਲੀਹਾਰ	گوربلیهار
ਗੁਰਬੀਨ੍ਦੇਰ	گوربیندیر
ਗੁਰਬੀਰ	گوربیر
ਗੁਰਭਜਨ	گوربھجن
ਗੁਰਭਾਗਤ	گوربھاگت
ਗੁਰਮਾਰ	گورمار
ਗੁਰਮਾਹੇਰ	گورماهیر
ਗੁਰਮੁਖ	گورموکھ
ਗੁਰਮੇਹਾਰ	گورمیهار
ਗੁਰਮੈਲ	گورمایل
ਗੁਰਮ੍ਰਿਤ	گورمریت
ਗੁਰਲੋਚਨ	گورلوچن
ਗੁਰਵਿਂਦਰ	گورویندر
ਗੁਰਵੀਨ੍ਦੇਰ	گورویندیر
ਗੁਰਵੀਰ	گورویر
ਗੁਰਸਨ੍ਦੀਪ	گورسندیپ
ਗੁਰਸ਼ਾਨ	گورسان
ਗੁਰਸੁਖ	گورسوکھ
ਗੁਰਸੇਵ	گورسیو
ਗੁਰਹਾਰ੍ਪਾਲ	گورهارپال
ਗੁਰਿਂਦਰ	گوریندر
ਗੁਰੀਨਦੇਰ੍ਪਾਲ	گوریندیرپال
ਗੁਰੁਕਾਰ	گوروکار
ਗੁਰੁਗੁਲ੍ਝਾਰ	گوروگولجھار
ਗੁਰੁਚਰਣ	گوروچرن
ਗੁਰੁਦਰ੍ਸ਼ਨ	گورودرسن
ਗੁਰੁਦਾਸ	گوروداس
ਗੁਰੁਦੀਪ	گورودیپ
ਗੁਰੁਪ੍ਰੇਮ	گوروپریم
ਗੁਰੁਬੀਰ	گوروبیر
ਗੁਰੁਮਾਂਨ੍ਦੀਰ	گورومانندیر
ਗੁਰੁਸੀਮ੍ਰਣ	گوروسیمرن
ਗੁਰ੍ਕੀਰਣ	گورکیرن
ਗੁਰ੍ਕੀਰਪਾਲ	گورکیرپال
ਗੁਰ੍ਚਾਰਾਨ੍ਜੋਤ	گورچارانجوت
ਗੁਰ੍ਜਨਪਾਲ	گورجنپال
ਗੁਰ੍ਜੁ	گورجو
ਗੁਰ੍ਤੇਜ	گورتیج
ਗੁਰ੍ਨੀਵਾਝ	گورنیواجھ
ਗੁਰ੍ਨੂਰ	گورنور
ਗੁਰ੍ਪ੍ਰਿਤੀ	گورپریتی
ਗੁਰ੍ਮੀਤ	گورمیت
ਗੁਰ੍ਮੀਨਦੇਰ	گورمیندیر
ਗੁਰ੍ਮੁਖਨੀਹਲ	گورموکھنیهل
ਗੁਰ੍ਸ਼ਣ	گورسن
ਗੁਰ੍ਸ਼ਾਂਤ	گورسانت
ਗੁਰ੍ਸ਼ੀਲ	گورسیل
ਗੁਰ੍ਸਾਹੇਬ	گورساهیب
ਗੁਲਦੀਪ	گولدیپ
ਗੁਲਵਂਤ	گولونت
ਗੁਲਸ਼ਾਨ੍ਰੂਪ	گولسانروپ
ਗੁਲ੍ਵਾਨ੍ਤਪ੍ਰਿਤ	گولوانتپریت
ਗੁਲ੍ਸ਼ਾਨਪ੍ਰਿਤ	گولسانپریت
ਗੁਲ੍ਸ਼ਾਨਮਿਤ	گولسانمیت
ਗੋਪਲਪ੍ਰਿਤ	گوپلپریت
ਗੋਬਿਂਦ	گوبیند
ਗੋਬੀਨਦੇਰ	گوبیندیر
ਗੋਬੀਨਦੇਰ੍ਜਿਤ	گوبیندیرجیت
ਗੋਬੀਨ੍ਦਰਾਈ	گوبیندرااِ
ਗੌਰਵ੍ਪ੍ਰਿਤ	گاوروپریت
ਘਮਾਂਨਦ੍ਜਿਤ	گھمانندجیت
ਘਮਾਂਨਦ੍ਪਾਲ	گھمانندپال
ਚਂਚਲਜਿਤ	چنچلجیت
ਚਂਚਲ੍ਪ੍ਰੀਤ	چنچلپریت
ਚਂਦਨ	چندن
ਚਂਦਨਦੀਪ	چندندیپ
ਚਮਕੌਰ	چمکاور
ਚਮਨਜਿਤ	چمنجیت
ਚਮਨਪ੍ਰਿਤ	چمنپریت
ਚਮਨਰੂਪ	چمنروپ
ਚਰਨਕਾਨ੍ਵਾਲ	چرنکانوال
ਚਰਨਜੋਤ /ਚਰਨਜ੍ਯੋਤ	چرنجوت /چرنجیوت
ਚਰਨਪ੍ਰੇਮ	چرنپریم
ਚਾਂਦ	چاند
ਚਿਤਰਾਮਣ	چیترامن
ਚਿਤਸਰੂਪ	چیتسروپ
ਚੀਤਪ੍ਰਿਤ	چیتپریت
ਚੇਤਨ੍ਦੀਪ	چیتندیپ
ਜਗਜੀਤ	جگجیت
ਜਗਜੀਵ	جگجیو
ਜਗਜੀਵਨ	جگجیون
ਜਗਤਜੀਤ	جگتجیت
ਜਗਤਪ੍ਰੇਮ	جگتپریم
ਜਗਤਰਣ	جگترن
ਜਗਤਰੂਪ	جگتروپ
ਜਗਨ	جگن
ਜਗਪਾਲ	جگپال
ਜਗਪ੍ਰਿਤ	جگپریت
ਜਗਪ੍ਰੇਮ	جگپریم
ਜਗਮਿਤ	جگمیت
ਜਗਮੇਹਾਰ	جگمیهار
ਜਗਮੋਹਨ	جگموهن
ਜਗਰਾਜ	جگراج
ਜਗਰੂਪ	جگروپ
ਜਗਵੀਨ੍ਦੇਰ	جگویندیر
ਜਗਵੀਰ	جگویر
ਜਗੀਨਦੇਰ	جگیندیر
ਜਗੀਨ੍ਦੇਰਪਾਲ	جگیندیرپال
ਜਗ੍ਵੀਰ	جگویر
ਜਘ੍ਰ	جگھر
ਜਤੀਨਦੇਰ੍ਜਿਤ	جتیندیرجیت
ਜਤੀਨਦੇਰ੍ਬੀਰ	جتیندیربیر
ਜਤੀਨਦੇਰ੍ਮਿਤ	جتیندیرمیت
ਜਨਜਿਤ	جنجیت
ਜਨਜੋਤ	جنجوت
ਜਨਪ੍ਰਿਤ	جنپریت
ਜਨਰਾਜ	جنراج
ਜਨਿਸ਼	جنیس
ਜਪਜਿਤ	جپجیت
ਜਪਧਾਰਾਮ	جپدھارام
ਜਪਧਿਰ	جپدھیر
ਜਪਨਾਮ	جپنام
ਜਪਸ਼ੇਰ	جپسیر
ਜਪੁਜੀ	جپوجی
ਜਬਰਜਂਗ	جبرجنگ
ਜਮੀਲ	جمیل
ਜਯਂਸ਼	جینس
ਜਯਪਾਲ	جیپال
ਜਰ੍ਨੈਲ	جرنایل
ਜਲਿਨ੍ਦ੍ਰ	جلیندر
ਜਲ੍ਬੀਰ	جلبیر
ਜਸਂਜੋਤ	جسنجوت
ਜਸਂਪਾਲ	جسنپال
ਜਸਂਮਿਤ	جسنمیت
ਜਸਕੀਰਣ	جسکیرن
ਜਸਗੁਰ੍ਕੀਰ੍ਤਤ	جسگورکیرتت
ਜਸਜੀਨ੍ਦੇਰ	جسجیندیر
ਜਸਜੀਵਨ	جسجیون
ਜਸਜੋਤ	جسجوت
ਜਸਤਰਣ	جسترن
ਜਸਨਾਮ	جسنام
ਜਸਪਾਲ (ਪੁਲ )	جسپال (پول )
ਜਸਬੀਰ	جسبیر
ਜਸਭੂਪ	جسبھوپ
ਜਸਮਿਂਦਰ	جسمیندر
ਜਸਮੋਹਨ	جسموهن
ਜਸਰੂਪ	جسروپ
ਜਸ੍ਕਰਣ	جسکرن
ਜਸ੍ਕੀਰਿਤ	جسکیریت
ਜਸ੍ਕੀਰ੍ਪਲ	جسکیرپل
ਜਸ੍ਗੁਨ	جسگون
ਜਸ੍ਮਿਤ	جسمیت
ਜਸ੍ਮੀਨਪ੍ਰਿਤ	جسمینپریت
ਜਸ੍ਰਜਪ੍ਰਿਤ	جسرجپریت
ਜਸ੍ਸੀ	جسسی
ਜਾਗ	جاگ
ਜਾਗਰੀਤ	جاگریت
ਜਾਤਵਂਤ	جاتونت
ਜਾਤਿਨਦੇਰ੍ਦੀਪ	جاتیندیردیپ
ਜਾਨਾਕਪ੍ਰਿਤ	جاناکپریت
ਜਾਪਮਾਨ	جاپمان
ਜਾਸਨਿਤ	جاسنیت
ਜਾਸ਼ਾਨਪ੍ਰਿਤ	جاسانپریت
ਜਾਸ੍ਮੀਲ	جاسمیل
ਜੀਵਨਦੀਪ ; ਜੀਵਨਦੀਪ ; ਜੀਵਨਦੀਪ	جیوندیپ ; جیوندیپ ; جیوندیپ
ਜੀਵਨਪਲ	جیونپل
ਜੀਵਨਪ੍ਰਿਤ	جیونپریت
ਜੀਵਾਨਬੀਰ	جیوانبیر
ਜੁਗਦ	جوگد
ਜੁਪੀਨਦੇਰਦੀਪ	جوپیندیردیپ
ਜੁਪੀਨਦੇਰ੍ਬੀਰ	جوپیندیربیر
ਜੁਸਜਿਤ	جوسجیت
ਜੁਸਪੁਲ	جوسپول
ਜੁਸਮੈਲ	جوسمایل
ਜੇਬਾ	جیبا
ਜੇਸਪਾਲ	جیسپال
ਜੈਕਾਰ	جایکار
ਜੈਪ੍ਰਜ	جایپرج
ਜੈਪ੍ਰਤਨ	جایپرتن
ਜੈਬੀਰ	جایبیر
ਜੈਸਂਗਤ	جایسنگت
ਜੈਸੁਖਬੀਰ	جایسوکھبیر
ਜੋਗਧੀਆਨ	جوگدھیآن
ਜੋਗਪ੍ਰਕਾਸ਼	جوگپرکاس
ਜੋਗੀਨਦੇਰ੍ਬੀਰ	جوگیندیربیر
ਜੋਗੀਨਦੇਰ੍ਮਿਤ	جوگیندیرمیت
ਜੋਗੇਨਦੇਰ	جوگیندیر
ਜੋਤਪ੍ਰਕਾਸ਼	جوتپرکاس
ਜੋਬਨਰੂਪ	جوبنروپ
ਜੋਹਾਰ	جوهار
ਜ੍ਞਾਨਜਿਤ	جنانجیت
ਜ੍ਞਾਨਜੋਤ	جنانجوت
ਜ੍ਞਾਨਪ੍ਰਿਤ	جنانپریت
ਜ੍ਞਾਨਰੂਪ	جنانروپ
ਜ੍ਞਾਨਵੀਰ	جنانویر
ਜ੍ਞਾਨੇਨ੍ਦੇਰ	جنانیندیر
ਜ੍ਹਮਕ	جهمک
ਜ੍ਹਾਗਰ	جهاگر
ਝਈਤੂਨ	جھاِتون
ਝਹਾਗਨ	جھهاگن
ਝਾਮੀਨਾਹ	جھامیناه
ਝੀਤੁਨ	جھیتون
ਝੀਲ	جھیل
ਝੁਲਾਖਾ	جھولاکھا
ਝੁਲ੍ਫਾ	جھولپھا
ਝੇਬਵਂਤ	جھیبونت
ਝੋਰਾਵਾਰ	جھوراوار
ਟੇਇਜਿਨ੍ਦੇਰ	ٹیاِجیندیر
ਤਕਦੀਰ	تکدیر
ਤਖਤ	تکھت
ਤਤਜੋਗ	تتجوگ
ਤਤਬੀਰ	تتبیر
ਤਤਵਿਚਾਰ	تتویچار
ਤਤ੍ਰਾਤਨ	تتراتن
ਤਦਬੀਰ	تدبیر
ਤਨਦੀਪ	تندیپ
ਤਨਵੀਰ	تنویر
ਤਮਨ੍ਪ੍ਰਿਤ	تمنپریت
ਤਰਣਵੀਰ	ترنویر
ਤਰਲੋਚਨ	ترلوچن
ਤਰਸੇਮ	ترسیم
ਤਰੁਨਜਿਤ	ترونجیت
ਤਲਵਿਨ	تلوین
ਤਾਜਦਾਰ	تاجدار
ਤਾਜੀਨਦੇਰ੍ਦੀਪ	تاجیندیردیپ
ਤਾਜੀਨਦੇਰ੍ਪ੍ਰੇਮ	تاجیندیرپریم
ਤਾਨੁਪ੍ਰਿਤ	تانوپریت
ਤਾਪਨਪਾਲ	تاپنپال
ਤੀਰਨ /ਤਿਹ੍ਰਣ /ਤੇਯ੍ਰੁਣ	تیرن /تیهرن /تییرون
ਤੀਰਾਥ੍ਰਾਮ	تیراتھرام
ਤੁਵਿਜਾਤ	توویجات
ਤੇਕਜੀਤ	تیکجیت
ਤੇਕਦੀਪ	تیکدیپ
ਤੇਕਪ੍ਰਿਤ	تیکپریت
ਤੇਕ੍ਪਾਲ	تیکپال
ਤੇਘਬਹਾਦੁਰ	تیگھبهادور
ਤੇਜਧਾਰਾਮ	تیجدھارام
ਤੇਜਨਾਮ	تیجنام
ਤੇਜਪ੍ਰਤਾਪ	تیجپرتاپ
ਤੇਜ਼	تیج
ਤੇਜਾਸਵੀਰ	تیجاسویر
ਤੇਜੀਨਦੇਰ੍ਜੀਤ	تیجیندیرجیت
ਤੇਜੀਨਦੇਰ੍ਪਾਲ	تیجیندیرپال
ਤੋਤਾਸਿਂਹ	توتاسینه
ਤ੍ਰਿਪਲ	تریپل
ਤ੍ਰਿਲੋਚਨ	تریلوچن
ਤ੍ਰੀਭਾਵਾਨ	تریبھاوان
ਤ੍ਰੀਸ਼ਾਨਜੋਤ	تریسانجوت
ਤ੍ਰੀਸ਼ਾਨਦੀਪ	تریساندیپ
ਤ੍ਰੀਸ਼ਾਨਬੀਰ	تریسانبیر
ਥਾਕੁਰਨਾਮ	تھاکورنام
ਥਾਲਭੂਪ	تھالبھوپ
ਥਾਲਰਾਜ	تھالراج
ਥੀਰਮਾਨ	تھیرمان
ਥੀਰ੍ਧੀਆਨ	تھیردھیآن
ਦਮਨਜਿਤ	دمنجیت
ਦਮਨਜੋਤ	دمنجوت
ਦਯਾਜੋਤ	دیاجوت
ਦਯਾਦੀਪ	دیادیپ
ਦਰਮੀਨ੍ਦੇਰ	درمیندیر
ਦਰ੍ਪ੍ਰਿਤ	درپریت
ਦਲਜੋਧ	دلجودھ
ਦਲਬੀਨਦੇਰ	دلبیندیر
ਦਲਬੀਨ੍ਦੇਰ੍ਜਿਤ	دلبیندیرجیت
ਦਲਰਾਜ	دلراج
ਦਲੇਰ	دلیر
ਦਵੀਨ੍ਦੇਰ	دویندیر
ਦਿਦਾਰ	دیدار
ਦਿਨਤੇਕ	دینتیک
ਦਿਪਲੀਨ	دیپلین
ਦਿਲਜੋਤ	دیلجوت
ਦਿਲਨਿਤ	دیلنیت
ਦਿਲਪ੍ਰਿਤ	دیلپریت
ਦਿਲਮਿਤ	دیلمیت
ਦਿਲਰਿਤ	دیلریت
ਦਿਲਸ਼ਾਨ	دیلسان
ਦਿਲਸ਼ੇਰ	دیلسیر
ਦਿਵ੍ਯਜ੍ਯੋਤ	دیویجیوت
ਦੀਲਜੀਤ	دیلجیت
ਦੀਲਬਾਘ	دیلباگھ
ਦੀਲ੍ਜਿਤ	دیلجیت
ਦੀਵ੍ਯਜੋਤ	دیویجوت
ਦੇਵਜੀਤ	دیوجیت
ਦੇਵਪ੍ਰਿਤ	دیوپریت
ਦੇਵਾਤ੍ਮਾ	دیواتما
ਦੇਵੀਨ੍ਦੇਰ	دیویندیر
ਧਰਮਜ੍ਯੋਤ	دھرمجیوت
ਧਰਮਪਾਲ	دھرمپال
ਧਰਮਪ੍ਰੀਤ	دھرمپریت
ਧਰਮਲੀਨ	دھرملین
ਧੀਅਨ੍ਜੋਗ	دھیانجوگ
ਨਕ੍ਸ਼ਤ੍ਰਾ	نکسترا
ਨਮ੍ਰੀਤਾਬੀਰ	نمریتابیر
ਨਯਨਦੀਪ	نیندیپ
ਨਰਿਨ੍ਦਰ	نریندر
ਨਰੇਨ੍ਦ੍ਰ	نریندر
ਨਵਜੀਤ	نوجیت
ਨਵਜੀਵਨ	نوجیون
ਨਵਦੀਪ	نودیپ
ਨਵਬੀਰ	نوبیر
ਨਵਮਿਤ	نومیت
ਨਵ੍ਜੀਨ੍ਦੇਰ	نوجیندیر
ਨਾਗਂਦਰ	ناگندر
ਨਾਨਕੀ	نانکی
ਨਾਨਵੀਰ	نانویر
ਨਾਨ੍ਦਾਨਜਿਤ	ناندانجیت
ਨਾਨ੍ਦਾਨਪ੍ਰਿਤ	ناندانپریت
ਨਾਮਜੀਵ	نامجیو
ਨਾਮਜੋਗ	نامجوگ
ਨਾਮਜੋਤ	نامجوت
ਨਾਮਜੋਧ	نامجودھ
ਨਾਮਧਾਰ	نامدھار
ਨਾਮਧਿਯਨ	نامدھیین
ਨਾਮਧਿਰ	نامدھیر
ਨਾਮਨੀਰ੍ਮਾਲ	نامنیرمال
ਨਾਮਨੀਵਾਸ	نامنیواس
ਨਾਮਪ੍ਰਿਤ	نامپریت
ਨਾਮਪ੍ਰੇਮ	نامپریم
ਨਾਮਭਾਗਤ	نامبھاگت
ਨਾਮਵਿਚਾਰ	نامویچار
ਨਾਮਸ਼ਰਣ	نامسرن
ਨਾਮਾਂਡੋਲ਼	نامانڈول
ਨਾਮਾਹਾਰ	ناماهار
ਨਾਮੁਤ੍ਤਮ	ناموتتم
ਨਾਮ੍ਰਾਤਨ	نامراتن
ਨਾਮ੍ਰਿਤਾ	نامریتا
ਨਾਮ੍ਰੀਤਾਜੋਤ	نامریتاجوت
ਨਾਮ੍ਰੀਤਾਦੀਪ	نامریتادیپ
ਨਾਮ੍ਰੀਤਾਪ੍ਰਿਤ	نامریتاپریت
ਨਾਰ	نار
ਨਾਰਂਜਨ	نارنجن
ਨਾਰੀਤਪਲ	ناریتپل
ਨਾਰੀਨਦੇਰਦੀਪ	ناریندیردیپ
ਨਾਰੈਨ	ناراین
ਨਾਵਿਨਜਿਤ	ناوینجیت
ਨਾਵ੍ਕੀਰਣ	ناوکیرن
ਨਾਵ੍ਕੀਰਨਜੋਤ	ناوکیرنجوت
ਨਾਵ੍ਪ੍ਰਿਤ	ناوپریت
ਨਿਮਾਈ	نیمااِ
ਨਿਰਂਜਨ	نیرنجن
ਨਿਰਂਜਨਾ	نیرنجنا
ਨਿਰ੍ਮਲਜੀਤ	نیرملجیت
ਨਿਲਾਮਜੋਤ	نیلامجوت
ਨਿਲਾਮਪੁਲ	نیلامپول
ਨਿਲਾਮਪ੍ਰਿਤ	نیلامپریت
ਨਿਲਾਮਬੇਰ	نیلامبیر
ਨਿਸ਼ਾ	نیسا
ਨਿਹ੍ਚਾਲਤੇਕ	نیهچالتیک
ਨਿਹ੍ਚਾਲਮਿਤ	نیهچالمیت
ਨੀਤਨਾਮ	نیتنام
ਨੀਨਦੇਰ੍ਬੀਰ	نیندیربیر
ਨੀਮਮਾਂਪ੍ਰਿਤ	نیممانپریت
ਨੀਮਮਾਂਰ੍ਦੀਪ	نیممانردیپ
ਨੀਮ੍ਮਾਂਰਤਾ	نیممانرتا
ਨੀਮ੍ਰਤ	نیمرت
ਨੀਰਮਾਂਲਦੀਪ	نیرمانلدیپ
ਨੀਰਮਾਂਲਬੀਰ	نیرمانلبیر
ਨੀਰਮੋਲ	نیرمول
ਨੀਰਵੈਰ	نیروایر
ਨੀਰ੍ਭਾਉ	نیربھاو
ਨੀਰ੍ਮਾਂਲਕਾਰਾਮ	نیرمانلکارام
ਨੀਰ੍ਮਾਂਲਜੀਵ	نیرمانلجیو
ਨੀਰ੍ਮਾਂਲਜੋਤ	نیرمانلجوت
ਨੀਰ੍ਮਾਂਲਤੇਕ	نیرمانلتیک
ਨੀਰ੍ਮਾਂਲਧਾਰਾਮ	نیرمانلدھارام
ਨੀਰ੍ਮਾਂਲਪ੍ਰਿਤ	نیرمانلپریت
ਨੀਸ਼ਾਨ੍ਦੀਪ	نیساندیپ
ਨੀਹ੍ਚਾਲ੍ਪ੍ਰੇਮ	نیهچالپریم
ਨੂਰਦੇਵ	نوردیو
ਨੂਰਨਿਤ	نورنیت
ਨੂਰਪ੍ਰਿਤ	نورپریت
ਨੇਕਨਾਮ	نیکنام
ਨੇਕੀਨਦੇਰ	نیکیندیر
ਨੇਕ੍ਦੀਪ	نیکدیپ
ਨੇਕ੍ਪਾਲ	نیکپال
ਨੇਹ੍ਚਾਲਪ੍ਰਿਤ	نیهچالپریت
ਨੈਨਤਾਰ	ناینتار
ਨੈਨਦੀਪ	نایندیپ
ਨੈਨੀਨਦੇਰ	ناینیندیر
ਨੋਉਲਖ	نوولکھ
ਨੌਹਨੀਹਲ	ناوهنیهل
ਨ੍ਰੀਪਜੋਤ	نریپجوت
ਪਤਵਂਤ	پتونت
ਪਤਵੀਰ	پتویر
ਪਦਾਮਜਿਤ	پدامجیت
ਪਦਾਮਪ੍ਰੇਮ	پدامپریم
ਪਦ੍ਮਸ਼੍ਰੀ	پدمسری
ਪਰਤਾਪ ; ਪਰਤਾਪ	پرتاپ ; پرتاپ
ਪਰਤਾਪੀ	پرتاپی
ਪਰਦੀਪ	پردیپ
ਪਰਬੀਨ	پربین
ਪਰਮਕਮਲ਼	پرمکمل
ਪਰਮਕਿਰਤ	پرمکیرت
ਪਰਮਗੁਨ	پرمگون
ਪਰਮਜਾਪ	پرمجاپ
ਪਰਮਜੀਤ ; ਪਰਮਜੀਤ	پرمجیت ; پرمجیت
ਪਰਮਜੁਗਤ	پرمجوگت
ਪਰਮਜੋਗ	پرمجوگ
ਪਰਮਜੋਧ	پرمجودھ
ਪਰਮਠਾਕਰ	پرمٹھاکر
ਪਰਮਤੇਕ	پرمتیک
ਪਰਮਦੀਪ	پرمدیپ
ਪਰਮਧਾਰਾਮ	پرمدھارام
ਪਰਮਧਿਰ	پرمدھیر
ਪਰਮਪਾਲ	پرمپال
ਪਰਮਪ੍ਰੇਮ	پرمپریم
ਪਰਮਬੋਧ	پرمبودھ
ਪਰਮਯੋਗ	پرمیوگ
ਪਰਮਰਂਗ	پرمرنگ
ਪਰਮਲੀਨ	پرملین
ਪਰਮਸ਼ਾਂਤ	پرمسانت
ਪਰਮਸਿਤਾਲ	پرمسیتال
ਪਰਮਸੁਖ	پرمسوکھ
ਪਰਮਸੇਵਕ	پرمسیوک
ਪਰਮਾਧਾਰ	پرمادھار
ਪਰਮਾਰ੍ਥ	پرمارتھ
ਪਰਮਿਂਦਰ	پرمیندر
ਪਰਮੀਤ	پرمیت
ਪਰਮ੍ਦਯਾ	پرمدیا
ਪਰਸਂਜੀਤ	پرسنجیت
ਪਰਸ਼ੋਤਮ	پرسوتم
ਪਰਾਮਨੀਵਾਸ	پرامنیواس
ਪਰੀਦਰ੍ਸ਼ਨ	پریدرسن
ਪਰ੍ਗਤ	پرگت
ਪਰ੍ਵੀਨ੍ਦੇਰ	پرویندیر
ਪਲਬੀਨਦੇਰ	پلبیندیر
ਪਲਵੀਨ੍ਦੇਰ੍ਪਾਲ	پلویندیرپال
ਪਵਾਨਜੋਤ	پوانجوت
ਪਵਾਨਦੀਪ	پواندیپ
ਪਵਾਨਪ੍ਰਿਤ	پوانپریت
ਪਵਾਨਵੀਰ	پوانویر
ਪਵੀਤ	پویت
ਪਾਰਂਗਤ	پارنگت
ਪੁਨੀਤ	پونیت
ਪੁਨੀਤਪਾਲ	پونیتپال
ਪੁਰਾਨਪ੍ਰੇਮ	پورانپریم
ਪੁਰਾਨ੍ਜੀਤ	پورانجیت
ਪੁਸ਼ਪ੍ਰਿਤ	پوسپریت
ਪੁਸ਼੍ਪਿਤਾ	پوسپیتا
ਪੂਰਨਜੀਤ	پورنجیت
ਪ੍ਰਗਿਤ	پرگیت
ਪ੍ਰਜਨਾ	پرجنا
ਪ੍ਰਣਿਤ	پرنیت
ਪ੍ਰਨੀਤਾ	پرنیتا
ਪ੍ਰਫੂਲਦੀਪ	پرپھولدیپ
ਪ੍ਰਭਕੀਰਤ	پربھکیرت
ਪ੍ਰਭਕੀਰ੍ਪਾਲ	پربھکیرپال
ਪ੍ਰਭਗੀਤ	پربھگیت
ਪ੍ਰਭਚਰਣ	پربھچرن
ਪ੍ਰਭਚੇਤਨ	پربھچیتن
ਪ੍ਰਭਜਿਤ	پربھجیت
ਪ੍ਰਭਜੀਤ	پربھجیت
ਪ੍ਰਭਜੀਵਨ	پربھجیون
ਪ੍ਰਭਜੋਗ	پربھجوگ
ਪ੍ਰਭਜੋਤੇ	پربھجوتے
ਪ੍ਰਭਜੋਧ	پربھجودھ
ਪ੍ਰਭਤਿਰਥ	پربھتیرتھ
ਪ੍ਰਭਦਾਸ	پربھداس
ਪ੍ਰਭਧਿਯਨ	پربھدھیین
ਪ੍ਰਭਧਿਰਾਜ	پربھدھیراج
ਪ੍ਰਭਨਾਮ	پربھنام
ਪ੍ਰਭਨੂਰ	پربھنور
ਪ੍ਰਭਪਰ੍ਵਾਨ	پربھپروان
ਪ੍ਰਭਬੋਧ	پربھبودھ
ਪ੍ਰਭਮਿਤ	پربھمیت
ਪ੍ਰਭਮੇਹਾਰ	پربھمیهار
ਪ੍ਰਭਲੀਨ	پربھلین
ਪ੍ਰਭਵਿਚਾਰ	پربھویچار
ਪ੍ਰਭਸਂਗਤ	پربھسنگت
ਪ੍ਰਭਸਿਤਾਲ	پربھسیتال
ਪ੍ਰਭਾਤਕੀਰਣ	پربھاتکیرن
ਪ੍ਰਭ੍ਰਮਣ	پربھرمن
ਪ੍ਰਭ੍ਰਾਤਨ	پربھراتن
ਪ੍ਰਭ੍ਰੂਪ	پربھروپ
ਪ੍ਰਸ਼ਾਰਨਬੀਰ	پرسارنبیر
ਪ੍ਰਿਤਮੋਹਨ	پریتموهن
ਪ੍ਰਿਤੀਨ੍ਦੇਰ	پریتیندیر
ਪ੍ਰਿਤ੍ਵੀਰ	پریتویر
ਪ੍ਰੀਤਪਾਲ	پریتپال
ਪ੍ਰੀਤਮ੍ਹਾਰੀ	پریتمهاری
ਪ੍ਰੀਤਾਮਜਿਤ	پریتامجیت
ਪ੍ਰੀਥਾਮ੍ਦੀਪ	پریتھامدیپ
ਪ੍ਰੀਥੀਪਾਲ	پریتھیپال
ਪ੍ਰੀਥ੍ਵੀਪਾਲ	پریتھویپال
ਪ੍ਰੇਮਜਿਤ	پریمجیت
ਪ੍ਰੇਮਤੇਕ	پریمتیک
ਪ੍ਰੇਮਪਾਲ	پریمپال
ਪ੍ਰੇਮਬਂਸ	پریمبنس
ਪ੍ਰੇਮਭਾਗਤ	پریمبھاگت
ਪ੍ਰੇਮਰਂਗ	پریمرنگ
ਪ੍ਰੇਮਰਮਣ	پریمرمن
ਪ੍ਰੇਮਰਸ	پریمرس
ਪ੍ਰੇਮਲੀਨ	پریملین
ਪ੍ਰੇਮਵਾਂਤ	پریموانت
ਪ੍ਰੇਮਸੀਰੀ	پریمسیری
ਪ੍ਰੇਮਸੁਖ	پریمسوکھ
ਪ੍ਰੇਮ੍ਵੀਰ	پریمویر
ਫਕੀਰ	پھکیر
ਫਤੇਹਕਾਰਾਮ	پھتیهکارام
ਫਤੇਹਪ੍ਰਿਤ	پھتیهپریت
ਫਤੇਹਬੀਰ	پھتیهبیر
ਫਤੇਹ੍ਵਂਤ	پھتیهونت
ਫਾਜਲ	پھاجل
ਫੁਲਵਂਤ	پھولونت
ਫੋਜੀਨਦੇਰ	پھوجیندیر
ਬਂਸਮਿਤ	بنسمیت
ਬਕ੍ਸ਼ੀ	بکسی
ਬਚਾਨਬੀਰ	بچانبیر
ਬਚੀਨ੍ਤ	بچینت
ਬਨੀਤ	بنیت
ਬਨੀਨਦੇਰ	بنیندیر
ਬਰਿਨ੍ਦ੍ਰ	بریندر
ਬਰੀਨ੍ਦੇਰ	بریندیر
ਬਲਤੇਜ	بلتیج
ਬਲਦੀਪ	بلدیپ
ਬਲਦੇਵ	بلدیو
ਬਲਮੋਹਨ	بلموهن
ਬਲਰਾਜ	بلراج
ਬਲਵਿਂਦਰ	بلویندر
ਬਲੀਨਦੇਰ	بلیندیر
ਬਲੀਹਾਰ	بلیهار
ਬਲ੍ਵਿਨ੍ਦ੍ਰ	بلویندر
ਬਲ੍ਵੀਨ੍ਦੇਰ	بلویندیر
ਬਹਾਦਰ	بهادر
ਬਾਲਮਿਤ	بالمیت
ਬਿਸ਼ਨਪਾਲ	بیسنپال
ਬਿਸ੍ਮੀਤ	بیسمیت
ਬੀਨਦੇਰ	بیندیر
ਬੀਨਾ	بینا
ਬੀਬੀਨਾਨਾਕੀ	بیبیناناکی
ਬੀਮਾਂਲਜੋਤ	بیمانلجوت
ਬੀਰੀਨਦਾਰ	بیریندار
ਬੀਸਮਾਧ	بیسمادھ
ਬੀਸ਼੍ਮਿਤ	بیسمیت
ਬੁਜੀ	بوجی
ਬੁਧ੍ਪ੍ਰਿਤ	بودھپریت
ਬੁਧ੍ਰੂਪ	بودھروپ
ਬੇਂਤ	بینت
ਬੇਨ੍ਨੀ	بیننی
ਬੇਬੇ	بیبے
ਬੈਰਾਗੀ	بایراگی
ਬ੍ਰਹਮਜੋਤ	برهمجوت
ਬ੍ਰਹਾਮਲੀਨ	برهاملین
ਬ੍ਰਹਾਮ੍ਜੀਤ	برهامجیت
ਬ੍ਰਹ੍ਮਲੀਨ	برهملین
ਬ੍ਰਹ੍ਮਵੀਰ	برهمویر
ਬ੍ਰਿਜੇਂਦਰ	بریجیندر
ਬ੍ਰੀਜੋਧ	بریجودھ
ਭਗਤ	بھگت
ਭਗਵਾਨ	بھگوان
ਭਜਨਿਕ	بھجنیک
ਭਰਪੂਰ	بھرپور
ਭਾਘਵੀਨ੍ਦੇਰ	بھاگھویندیر
ਭਾਜ੍ਨਾਮ	بھاجنام
ਭਾਜ੍ਨਿਤ	بھاجنیت
ਭਾਵਜਿਤ	بھاوجیت
ਭਾਵਜੀਨ੍ਦੇਰ	بھاوجیندیر
ਭਾਵਨਦੀਪ	بھاوندیپ
ਭਾਵਨੀਤ	بھاونیت
ਭਾਵਪਾਲ	بھاوپال
ਭਾਵਪ੍ਰੇਮ	بھاوپریم
ਭਾਵਲੀਨ	بھاولین
ਭੀਨਦੇਰ੍ਪਾਲ	بھیندیرپال
ਭੁਪੀਨ੍ਦੇਰ	بھوپیندیر
ਮਂਗਲਾ	منگلا
ਮਂਤੇਕ	منتیک
ਮਜਾਲ	مجال
ਮਣਿਪਾਲ	منیپال
ਮਧੁਪ੍ਰਿਤ	مدھوپریت
ਮਧੁਰਬੀਨ	مدھوربین
ਮਧੁਵਂਤ	مدھوونت
ਮਨਵਂਤ	منونت
ਮਰਦੁਲਾ	مردولا
ਮਸ੍ਤਪ੍ਰੇਮ	مستپریم
ਮਸ੍ਤਾਨ	مستان
ਮਸ੍ਤੁਕ	مستوک
ਮਸ੍ਤ੍ਵੀਰ	مستویر
ਮਹਨਬੀਰ	مهنبیر
ਮਹਾਜਿਤ	مهاجیت
ਮਹਾਨਗਿਯਨ	مهانگیین
ਮਹਾਨਗੀਤ	مهانگیت
ਮਹਾਨਗੁਨ	مهانگون
ਮਹਾਨਜਿਤ	مهانجیت
ਮਹਾਨਜੀਵਨ	مهانجیون
ਮਹਾਨਜੋਤ	مهانجوت
ਮਹਾਨਤੇਕ	مهانتیک
ਮਹਾਨਤ੍ਰੀਪਾਤ	مهانتریپات
ਮਹਾਨਦੀਪ	مهاندیپ
ਮਹਾਨਪਾਲ	مهانپال
ਮਹਾਨਪ੍ਰੇਮ	مهانپریم
ਮਹਾਨਭਗਤ	مهانبھگت
ਮਹਿਨਦੇਰ੍ਪ੍ਰਿਤ	مهیندیرپریت
ਮਹੀਨਗਾ	مهینگا
ਮਹੀਨਦੇਰ੍ਪਾਲ	مهیندیرپال
ਮਹੇਕਪ੍ਰਿਤ	مهیکپریت
ਮਹੇਨਦੇਰ	مهیندیر
ਮਹੇਰਬਾਨੀ	مهیربانی
ਮਹੇਸ਼ੀਨਦੇਰ	مهیسیندیر
ਮਾਂਨਕਰਣ	ماننکرن
ਮਾਂਨਗਲ੍ਪ੍ਰਿਤ	ماننگلپریت
ਮਾਂਨਵਾਨ੍ਤ੍ਬੀਰ	ماننوانتبیر
ਮਾਂਨਸੀਰਤ	ماننسیرت
ਮਾਂਨਾਵੀਨਦੇਰ	مانناویندیر
ਮਾਂਨਾਸਪ੍ਰੇਮ	مانناسپریم
ਮਾਂਨੀਨਦੇਰ੍ਬੀਰ	ماننیندیربیر
ਮਾਂਨੋਹਾਰਜੋਤ	ماننوهارجوت
ਮਾਂਨੋਹਾਰਦੀਪ	ماننوهاردیپ
ਮਾਂਨੋਹਾਰ੍ਜੀਤ	ماننوهارجیت
ਮਾਂਨੋਹਾਰ੍ਪਲ	ماننوهارپل
ਮਾਂਨ੍ਗਲ੍ਜੀਤ	ماننگلجیت
ਮਾਂਨ੍ਗਲ੍ਪ੍ਰੇਮ	ماننگلپریم
ਮਾਂਨ੍ਸ਼ਿਤਾਲ	ماننسیتال
ਮਾਦਨਬੀਰ	مادنبیر
ਮਾਦਾਨਕੀਰ੍ਪਾਲ	مادانکیرپال
ਮਾਦਾਨਪਾਲ	مادانپال
ਮਾਨਤੇਜ	مانتیج
ਮਾਨਦੇਵ	ماندیو
ਮਾਨਪੁਲ	مانپول
ਮਾਨਬੀਰ	مانبیر
ਮਾਨਰਿਤ	مانریت
ਮਾਨਾਸਦੀਪ	ماناسدیپ
ਮਾਨ੍ਕੀਰਣ	مانکیرن
ਮਾਨ੍ਗਲ੍ਜੋਤ	مانگلجوت
ਮਾਨ੍ਪ੍ਰੀਯਾ	مانپرییا
ਮਾਯ੍ਰਾਯ	مایرای
ਮਿਤ੍ਰਾ	میترا
ਮਿਤ੍ਰਾਜ	میتراج
ਮੀਰਾ	میرا
ਮੁਕੁਂਦਾ	موکوندا
ਮੁਕੁਨਦ੍ਪ੍ਰਿਤ	موکوندپریت
ਮੁਖ੍ਤਯਾਰ	موکھتیار
ਮੁਦ੍ਰਾ	مودرا
ਮੁਨਦੀਪ	موندیپ
ਮੁਨਲੇਨੇ	مونلینے
ਮੇਸ਼	میس
ਮੇਹਰ	میهر
ਮੇਹਾਰਤੇਕ	میهارتیک
ਮੇਹਾਰਪਲ	میهارپل
ਮੇਹਾਰਪ੍ਰਿਤ	میهارپریت
ਮੇਹਾਰਭੂਪ	میهاربھوپ
ਮੇਹਾਰਮਿਤ	میهارمیت
ਮੇਹੇਰ	میهیر
ਮੇਹੇਰਬਾਨੀ	میهیربانی
ਮੋਨੀਨ੍ਦੇਰ	مونیندیر
ਮੋਹਨਤੇਕ	موهنتیک
ਮੋਹਨਮਿਤ	موهنمیت
ਮੋਹਨਲੀਨ	موهنلین
ਮੋਹਨਵਂਤ	موهنونت
ਮੋਹਨਵੀਰ	موهنویر
ਮੋਹਿਨ੍ਦੇਰਪਾਲ	موهیندیرپال
ਮੋਹੇਨਪਲ	موهینپل
ਮੋਹੇਨਪ੍ਰਿਤ	موهینپریت
ਯਕਿਨ	یکین
ਯਸ਼ਜੋਤ	یسجوت
ਯਸ਼ਨੂਰ	یسنور
ਯਸ਼ਪਾਲ	یسپال
ਯਸ਼ਵਂਤ	یسونت
ਯਸ਼੍ਦੀਪ	یسدیپ
ਯਾਤੀਨਪਾਲ	یاتینپال
ਯਾਦਲੀਨ	یادلین
ਯਾਦਵੀਰ	یادویر
ਯਾਦ੍ਬੀਰ	یادبیر
ਯਾਸ੍ਮੀਨੇ	یاسمینے
ਯੁਵਰਾਨੀ	یوورانی
ਯੋਗੇਸ਼ਪਾਲ	یوگیسپال
ਰਂਗ ਰਮਨ	رنگ رمن
ਰਂਗਜੋਤ	رنگجوت
ਰਂਗਪ੍ਰਿਤ	رنگپریت
ਰਂਗਾਤਮ	رنگاتم
ਰਂਗੀਵਨ	رنگیون
ਰਂਜੀਤ	رنجیت
ਰਘੁਜਿਤ	رگھوجیت
ਰਘੁਬਂਸ	رگھوبنس
ਰਚਨਜਿਤ	رچنجیت
ਰਚਨਜੋਤ	رچنجوت
ਰਚ੍ਪੀਨਦੇਰ੍ਜਿਤ	رچپیندیرجیت
ਰਜੀਨਦਾਰ	رجیندار
ਰਣਦੀਪ	رندیپ
ਰਣਬੀਰ	رنبیر
ਰਤਨ੍ਕਾਰਾਮ	رتنکارام
ਰਤ੍ਤਾਨਜੋਤ	رتتانجوت
ਰਤ੍ਤਾਨਦੀਪ	رتتاندیپ
ਰਨਗ੍ਰਤ੍ਤੀ	رنگرتتی
ਰਨਪ੍ਰਿਤ	رنپریت
ਰਪੀਨਦੇਰ	رپیندیر
ਰਮਚੇਤਨ	رمچیتن
ਰਮਣੀਕ	رمنیک
ਰਮਨਜਿਤ	رمنجیت
ਰਮਨਦੀਪ	رمندیپ
ਰਮਨਿਤ	رمنیت
ਰਮਨੀਵਾਸ	رمنیواس
ਰਮਲੀਨ	رملین
ਰਮਾਂਨਜੋਤ	رماننجوت
ਰਮਾਂਨਰੂਪ	رماننروپ
ਰਮਾਂਨਸੁਖ	رماننسوکھ
ਰਮਿਤ	رمیت
ਰਮਿਨਾਜੀਤ	رمیناجیت
ਰਮੀਨਦੇਰ੍ਜਿਤ	رمیندیرجیت
ਰਮੀਨਦੇਰ੍ਪਾਲ	رمیندیرپال
ਰਮੀਨਦੇਰ੍ਪ੍ਰਿਤ	رمیندیرپریت
ਰਮੀਨਦੇਰ੍ਬੀਰ	رمیندیربیر
ਰਮੇਸ਼ਪਲ	رمیسپل
ਰਮੇਸ਼ਮਿਤ	رمیسمیت
ਰਵਜੋਤ	روجوت
ਰਵਨੀਤ	رونیت
ਰਵਿਨ੍ਦਰ	رویندر
ਰਵਿਰਾਜ	رویراج
ਰਵੀਦੀਪ	رویدیپ
ਰਵੀਨਦੇਰ੍ਦੀਪ	رویندیردیپ
ਰਵੀਨਦੇਰ੍ਮਿਤ	رویندیرمیت
ਰਸਂਜਿਤ	رسنجیت
ਰਸਂਜੋਤ	رسنجوت
ਰਸਂਮਿਤ	رسنمیت
ਰਸਗੁਨ	رسگون
ਰਸਜੋਤ	رسجوت
ਰਸਧਾਰਮ	رسدھارم
ਰਸਨਂਦ	رسنند
ਰਸਪ੍ਰਿਤ	رسپریت
ਰਸਬੀਰ	رسبیر
ਰਸਭਾਗਤ	رسبھاگت
ਰਸਮ	رسم
ਰਸਮ੍ਰਿਤ	رسمریت
ਰਸਲੀਨ	رسلین
ਰਸਵਂਤ	رسونت
ਰਸ਼ਾਨ੍ਪ੍ਰਿਤ	رسانپریت
ਰਸੁਤ੍ਤਮ	رسوتتم
ਰਹੁਲਜੀਤ	رهولجیت
ਰਹੁਲਦੀਪ	رهولدیپ
ਰਾਖਨਾਂ	راکھناں
ਰਾਖਬੀਰ	راکھبیر
ਰਾਜਕਿਰਣ	راجکیرن
ਰਾਜਦੀਪ	راجدیپ
ਰਾਜਨਾਰੀਨ੍ਦ	راجناریند
ਰਾਜਪਰਾਮ	راجپرام
ਰਾਜਪਾਲ	راجپال
ਰਾਜਪ੍ਰਤਾਪ	راجپرتاپ
ਰਾਜਮਂਦਰ	راجمندر
ਰਾਜਮਿਤ	راجمیت
ਰਾਜਸ਼ਰਣ	راجسرن
ਰਾਜਸੁਖ	راجسوکھ
ਰਾਜਾਨਜਿਤ	راجانجیت
ਰਾਜਾਨਮਿਤ	راجانمیت
ਰਾਜਾਨ੍ਦੀਪ	راجاندیپ
ਰਾਤਾਨਗੀਤ	راتانگیت
ਰਾਤਾਨਚੇਤਨ	راتانچیتن
ਰਾਤਾਨਜੀਵਨ	راتانجیون
ਰਾਤਾਨਪ੍ਰਿਤ	راتانپریت
ਰਾਤਾਨਮਿਤ	راتانمیت
ਰਾਤਾਨਵਂਤ	راتانونت
ਰਾਤਾਨਾਤਮ	راتاناتم
ਰਾਮਦਾਸ	رامداس
ਰਾਮਪਾਲ	رامپال
ਰਾਮਰਂਗ	رامرنگ
ਰਾਮਰਤ੍ਤਨ	رامرتتن
ਰਾਮਸੁਖ	رامسوکھ
ਰਾਸਰਮਣ	راسرمن
ਰਾਸ਼੍ਪਲ	راسپل
ਰਾਸ਼੍ਮੀਨਦੇਰ	راسمیندیر
ਰਿਧਿਮਾ	ریدھیما
ਰੀਜਕ	ریجک
ਰੀਤੀਨਦੇਰ	ریتیندیر
ਰੀਪਨ੍ਜੋਤ	ریپنجوت
ਰੀਪੁਦਮ	ریپودم
ਰੂਂਗ / ਰਂਗ	رونگ / رنگ
ਰੂਪਦੀਪ	روپدیپ
ਰੂਪਦੇਵ	روپدیو
ਰੂਪਵਂਤ	روپونت
ਰੇਗੇਨਦਰ	ریگیندر
ਰੋਸ਼ਨਦੀਪ	روسندیپ
ਰੌਸ਼ਾਨਪ੍ਰੇਮ	راوسانپریم
ਰੌਸ਼ਾਨਬੀਰ	راوسانبیر
ਲਕ੍ਸ਼੍ਮੀ	لکسمی
ਲਖਪ੍ਰਿਤ	لکھپریت
ਲਖਮਿਤ	لکھمیت
ਲਖਰੂਪ	لکھروپ
ਲਖਵੀਰ	لکھویر
ਲਵੇਨਿਤ	لوینیت
ਲਾਜਵਂਤ	لاجونت
ਲਾਵਪ੍ਰਿਤ	لاوپریت
ਲਾਵਿਨਦੀਪ	لاویندیپ
ਲੀਵਗੀਆਨ	لیوگیآن
ਲੀਵਚਿਤ	لیوچیت
ਲੀਵਚੇਤ	لیوچیت
ਲੀਵਜੋਤ	لیوجوت
ਲੀਵਨਾਮ	لیونام
ਲੀਵਸ਼ਰਣ	لیوسرن
ਲੀਵਾਵਤਰ	لیواوتر
ਲੋਕਪਾਲ	لوکپال
ਲੋਕਪ੍ਰਿਤ	لوکپریت
ਲੋਕਰੂਪ	لوکروپ
ਲੋਕ੍ਪ੍ਰੇਮ	لوکپریم
ਲੋਵਪ੍ਰੇਮ	لووپریم
ਲੋਵੇਦੀਪ	لوویدیپ
ਵਰੀਨਦੇਰ੍ਪਾਲ	وریندیرپال
ਵਰੁਨਜਿਤ	ورونجیت
ਵਰੁਨਦੀਪ	وروندیپ
ਵਸਂਤਪ੍ਰਿਤ	وسنتپریت
ਵਸੁਂਧਰਾ	وسوندھرا
ਵਾਦਭਾਗ	وادبھاگ
ਵਾਮਾਂਨਜੀਤ	واماننجیت
ਵਾਰੀਨਦੇਰ	واریندیر
ਵਾਸੀਮਬੀਰ	واسیمبیر
ਵਾਹੀਦਪ੍ਰਿਤ	واهیدپریت
ਵਾਹੇਗੁਰੁ	واهیگورو
ਵਿਕ੍ਰਮਜੀਤ	ویکرمجیت
ਵਿਕ੍ਰਮਜੋਤ	ویکرمجوت
ਵਿਚਾਰ੍ਚੇਤਨ	ویچارچیتن
ਵਿਚਾਰ੍ਦੀਪ	ویچاردیپ
ਵਿਚਾਰ੍ਲੀਨ	ویچارلین
ਵਿਜਯਪ੍ਰਤਾਪ	ویجیپرتاپ
ਵਿਜਯਪ੍ਰਿਤ	ویجیپریت
ਵਿਜੇਂਦਰ	ویجیندر
ਵਿਨਾਯਦੀਪ	وینایدیپ
ਵਿਨਾਯਪੁਲ	وینایپول
ਵਿਨਾਯ੍ਬਿਰ	وینایبیر
ਵਿਮਾਂਲਜਿਤ	ویمانلجیت
ਵਿਮਾਂਲਜੋਤ	ویمانلجوت
ਵਿਮਾਂਲਪ੍ਰੇਮ	ویمانلپریم
ਵਿਰੀਨਦਾਰ ; ਵਿਰੀਨਦੇਰ	ویریندار ; ویریندیر
ਵਿਰੀਨਦੇਰ	ویریندیر
ਵਿਸਮਦ	ویسمد
ਵਿਸ਼ਾਲਦੀਪ	ویسالدیپ
ਵਿਸ਼ਾਲਪ੍ਰਿਤ	ویسالپریت
ਵਿਸ਼੍ਵਰ੍ਪ੍ਰਿਤ	ویسورپریت
ਵਿਸ਼੍ਵਾਤਮ	ویسواتم
ਵਿਸਾਹ	ویساه
ਵੀਜਯਮਿਤ	ویجیمیت
ਵੀਰ	ویر
ਵੀਰ /ਵੀਰ	ویر /ویر
ਵੀਰਪਾਲ	ویرپال
ਵੀਵੇਕ੍ਬੀਰ	ویویکبیر
ਵੀਸ੍ਰਮਣ	ویسرمن
ਵੇਰਾਜ	ویراج
ਵੈਭਵ	وایبھو
ਸਂਗਜਾਪ	سنگجاپ
ਸਂਗਤਪ੍ਰਿਤ	سنگتپریت
ਸਂਗਤਰੂਪ	سنگتروپ
ਸਂਗਤ੍ਰਸ	سنگترس
ਸਂਗੀਤਾ	سنگیتا
ਸਂਗ੍ਰਾਮ	سنگرام
ਸਂਜੀਤ	سنجیت
ਸਂਜੋਗ	سنجوگ
ਸਂਤਕੀਰੀਨ	سنتکیرین
ਸਂਤਪ੍ਰਕਾਸ਼	سنتپرکاس
ਸਂਤਪ੍ਰੇਮ	سنتپریم
ਸਂਤਬੀਰ	سنتبیر
ਸਂਤੋਖਜੀਤ	سنتوکھجیت
ਸਂਤੋਖਜੋਤ	سنتوکھجوت
ਸਂਤੋਖਪ੍ਰਿਤ	سنتوکھپریت
ਸਂਤੋਖਬੀਰ	سنتوکھبیر
ਸਂਦੀਪ	سندیپ
ਸਗਲਜੋਤ	سگلجوت
ਸਚਕਿਰਤ	سچکیرت
ਸਚਜੋਗ	سچجوگ
ਸਚਪਾਲ	سچپال
ਸਚਪ੍ਰਧਾਨ	سچپردھان
ਸਚਭਾਗਤ	سچبھاگت
ਸਚਮਾਨ	سچمان
ਸਚਰੂਪ	سچروپ
ਸਚਵੀਰ	سچویر
ਸਚਸੁਖ	سچسوکھ
ਸਚਸੇਵਕ	سچسیوک
ਸਚਾਮ੍ਰਿਤ	سچامریت
ਸਚ੍ਦੀਪ	سچدیپ
ਸਜੀਨਦੇਰ	سجیندیر
ਸਤਕਿਰਤ	ستکیرت
ਸਤਕੀਰਤ	ستکیرت
ਸਤਕੀਰ੍ਤਨ	ستکیرتن
ਸਤਗੁਨ	ستگون
ਸਤਗੁਰ	ستگور
ਸਤਜੋਤ	ستجوت
ਸਤਨਾਮ	ستنام
ਸਤਪਾਲ	ستپال
ਸਤਪ੍ਰਕਾਸ਼	ستپرکاس
ਸਤਪ੍ਰਿਤ	ستپریت
ਸਤਪ੍ਰੇਮ	ستپریم
ਸਤਬਚਨ	ستبچن
ਸਤਮਿਤ	ستمیت
ਸਤਰਜਿਤ	سترجیت
ਸਤਰਾਜ	ستراج
ਸਤਲੀਨ	ستلین
ਸਤਵਂਤ	ستونت
ਸਤਸਂਗਤ	ستسنگت
ਸਤਸਂਤੋਖ	ستسنتوکھ
ਸਤਸਰਂਗ	ستسرنگ
ਸਤਸੁਖ	ستسوکھ
ਸਤੀਨਦੇਰ੍ਜਿਤ	ستیندیرجیت
ਸਤ੍ਯਜਿਤ	ستیجیت
ਸਤ੍ਯਪ੍ਰੇਮ	ستیپریم
ਸਥਿਨ੍ਦਰ	ستھیندر
ਸਦਜੀਵਨ	سدجیون
ਸਦਸੁਖ	سدسوکھ
ਸਨਮੁਖ	سنموکھ
ਸਨਾਨਤਨ	سنانتن
ਸਪਨਦੀਪ	سپندیپ
ਸਪਾਹੀ	سپاهی
ਸਬੂਰੀ	سبوری
ਸਭਾਜੀਤ	سبھاجیت
ਸਮਰਜੀਤ	سمرجیت
ਸਮਰਣ	سمرن
ਸਮਰਵੀਰ	سمرویر
ਸਮਰ੍ਥ	سمرتھ
ਸਮਾਂਰਬੀਰ	سمانربیر
ਸਮਾਂਰ੍ਜੋਤ	سمانرجوت
ਸਮਾਈ	سمااِ
ਸਮੀਨਦੀਪ	سمیندیپ
ਸਮੀਰ	سمیر
ਸਰਦਾਰ	سردار
ਸਰਨਦਾਯਲ	سرندایل
ਸਰਨਦੀਪ	سرندیپ
ਸਰਨਾਗਤ	سرناگت
ਸਰਬਜੀਤ / ਸਰਬਜੀਤ	سربجیت / سربجیت
ਸਰਬਨੀਵਾਸ	سربنیواس
ਸਰਬਪ੍ਰਿਤ	سربپریت
ਸਰਬਸੁਖ	سربسوکھ
ਸਰਬੁਤ੍ਤਮ	سربوتتم
ਸਰਬ੍ਗਿਆਨ	سربگیآن
ਸਰਬ੍ਜਿਤ	سربجیت
ਸਰਬ੍ਦਾਯਲ	سربدایل
ਸਰਬ੍ਦੀਪ	سربدیپ
ਸਰਬ੍ਦੇਵ	سربدیو
ਸਰਬ੍ਧਾਰਾਮ	سربدھارام
ਸਰਲਜਿਤ	سرلجیت
ਸਰਲਬੀਰ	سرلبیر
ਸਰਾਬ੍ਰਜ	سرابرج
ਸਰੂਪ	سروپ
ਸਰੂਰ	سرور
ਸਰ੍ਜਿਤ	سرجیت
ਸਰ੍ਮੀਨਦੇਰ	سرمیندیر
ਸਵਾਨਪ੍ਰਿਤ	سوانپریت
ਸਵਾਰਜਦੀਪ	سوارجدیپ
ਸਵਾਰਜਬੀਰ	سوارجبیر
ਸਵਾਰਨਜੋਤ	سوارنجوت
ਸਵਾਰਨਪ੍ਰਿਤ	سوارنپریت
ਸਵੀਤੀਨਦੇਰ	سویتیندیر
ਸਵੀਤੋਜ	سویتوج
ਸਵੀਨਦੇਰ	سویندیر
ਸਹੀਲਮਿਤ	سهیلمیت
ਸ਼ਯ੍ਮ੍ਸੁਨ੍ਦਾਰ	سیمسوندار
ਸ਼ਰਨਪਾਲ	سرنپال
ਸ਼ਰਨਬੀਰ	سرنبیر
ਸ਼ਰਨ੍ਜੀਤ੍ਕੌਰ	سرنجیتکاور
ਸ਼ਾਂਤਚਿਤ	سانتچیت
ਸ਼ਾਂਤਦੀਪ	سانتدیپ
ਸ਼ਾਂਤਪ੍ਰਕਾਸ਼	سانتپرکاس
ਸ਼ਾਂਤਪ੍ਰਿਤ	سانتپریت
ਸ਼ਾਂਤਬੀਰ	سانتبیر
ਸ਼ਾਂਤਲੀਨ	سانتلین
ਸ਼ਾਨਤ੍ਨੀਵਾਸ	سانتنیواس
ਸ਼ਾਬਦਚੇਤ	سابدچیت
ਸ਼ਾਬਦਤੇਕ	سابدتیک
ਸ਼ਾਬਦ੍ਰਾਸ	سابدراس
ਸ਼ਾਬਾਦ੍ਦੀਪ	ساباددیپ
ਸ਼ਾਲੀਨ	سالین
ਸ਼ਾਸ਼ੀਪ੍ਰਿਤ	ساسیپریت
ਸ਼ਿਵਚਰਣ	سیوچرن
ਸ਼ਿਵ੍ਚਾਰਨ੍ਜੀਤ	سیوچارنجیت
ਸ਼ੁਕਾਰਿਯਨ	سوکاریین
ਸ਼ੁਭਦੀਪ	سوبھدیپ
ਸ਼ੂਰਵੀਰ	سورویر
ਸ਼ੇਰ	سیر
ਸ਼ੇਰਪੁਲ	سیرپول
ਸ਼ੇਰਬਹਾਦੁਰ	سیربهادور
ਸ਼ੇਹ੍ਬਾਝ	سیهباجھ
ਸਾਕਰਥ	ساکرتھ
ਸਾਖ	ساکھ
ਸਾਗਰ	ساگر
ਸਾਜ	ساج
ਸਾਤਪੁਲ	ساتپول
ਸਾਧਨਾਹ	سادھناه
ਸਾਧਿਕਾ	سادھیکا
ਸਾਬਰ	سابر
ਸਾਰ	سار
ਸਿਂਦਾ	سیندا
ਸਿਓਪਰਿਤ	سیاوپریت
ਸਿਤਾਲਜੀਤ	سیتالجیت
ਸਿਤਾਲਜੋਤ	سیتالجوت
ਸਿਮਰਨ	سیمرن
ਸੀਖਲ	سیکھل
ਸੀਮਾਂਰ੍ਜਿਤ	سیمانرجیت
ਸੀਮਾਂਰ੍ਨਾਮ	سیمانرنام
ਸੀਮਾਂਰ੍ਪ੍ਰਿਤ	سیمانرپریت
ਸੀਮਾਂਰ੍ਲੀਨ	سیمانرلین
ਸੀਮ੍ਰਤ	سیمرت
ਸੀਮ੍ਰਨਪਾਲ	سیمرنپال
ਸੀਮ੍ਰਨਪ੍ਰਿਤ	سیمرنپریت
ਸੀਮ੍ਰਨ੍ਕੌਰ	سیمرنکاور
ਸੀਮ੍ਰਨ੍ਜੀਤ	سیمرنجیت
ਸੀਮ੍ਰੀਤਾ	سیمریتا
ਸੀਰਤ	سیرت
ਸੀਰੀਪ੍ਰੀਤਮ	سیریپریتم
ਸੀਰੀਵੇਦ੍ਯਾ	سیریویدیا
ਸੀਰੀਸੀਮ੍ਰਣ	سیریسیمرن
ਸੀਰੀਸੇਵਾ	سیریسیوا
ਸੁਖਚੈਨ	سوکھچاین
ਸੁਖਜੀਵਨ	سوکھجیون
ਸੁਖਜੋਤ	سوکھجوت
ਸੁਖਜੋਧ	سوکھجودھ
ਸੁਖਦਾਯਲ	سوکھدایل
ਸੁਖਦੀਪ	سوکھدیپ
ਸੁਖਦੇਵ	سوکھدیو
ਸੁਖਬੀਰ	سوکھبیر
ਸੁਖਮਾਂ	سوکھماں
ਸੁਖਰੂਪ	سوکھروپ
ਸੁਖਸਿਤਾਲ	سوکھسیتال
ਸੁਖਸੀਮ੍ਰਣ	سوکھسیمرن
ਸੁਖਾਨਂਦ	سوکھانند
ਸੁਖਿਤ	سوکھیت
ਸੁਖੀਨ	سوکھین
ਸੁਖੀਨ੍ਦੇਰ	سوکھیندیر
ਸੁਖ੍ਚਾਰਨ੍ਜੀਤ	سوکھچارنجیت
ਸੁਖ੍ਜਿਤ	سوکھجیت
ਸੁਚਦੀਪ	سوچدیپ
ਸੁਚਦੇਵ	سوچدیو
ਸੁਚਮ	سوچم
ਸੁਜਨਰੂਪ	سوجنروپ
ਸੁਜਨ੍ਬੀਰ	سوجنبیر
ਸੁਜ੍ਜਨ	سوججن
ਸੁਧਬੁਧ	سودھبودھ
ਸੁਧਸੁਰਤ	سودھسورت
ਸੁਭਪ੍ਰਿਤ	سوبھپریت
ਸੁਹੇਜਦੀਪ	سوهیجدیپ
ਸੇਵਾਕਪ੍ਰਿਤ	سیواکپریت
ਸੇਵਾਕਪ੍ਰੇਮ	سیواکپریم
ਸੇਵਾਕਰਣ	سیواکرن
ਸੇਵਾਪ੍ਰੀਤ	سیواپریت
ਸੇਹਜ	سیهج
ਸੇਹੇਜਬੀਰ	سیهیجبیر
ਸੈਲੇਸ਼ਦੀਪ	سایلیسدیپ
ਸੈਹਜ	سایهج
ਸੈਹਾਜਨੀਵਾਸ	سایهاجنیواس
ਸੈਹਾਜਲੀਨ	سایهاجلین
ਸੈਹਾਜਾਧਾਰ	سایهاجادھار
ਸੋਚੀ	سوچی
ਸੋਨਹਨ	سونهن
ਸੋਭਾਵਂਤ	سوبھاونت
ਸੋਹੀਨਦੇਰ	سوهیندیر
ਸੋਹੁਨ	سوهون
ਸ੍ਵਰ੍ਨ	سورن
ਹਕਾਮਪ੍ਰਿਤ	هکامپریت
ਹਨ੍ਸ੍ਪਾਲ	هنسپال
ਹਰਕਾਨ੍ਵਾਲ	هرکانوال
ਹਰਕੀਰਣ	هرکیرن
ਹਰਗੀਤ	هرگیت
ਹਰਗੁਰ੍ਮਿਤ (ਮਿਤ )	هرگورمیت (میت )
ਹਰਗੋਬੀਨ੍ਦ	هرگوبیند
ਹਰਚਰਣ	هرچرن
ਹਰਜਪ	هرجپ
ਹਰਜੀ	هرجی
ਹਰਜੀਤ	هرجیت
ਹਰਜੀਨ੍ਦੇਰ	هرجیندیر
ਹਰਜੀਵ	هرجیو
ਹਰਜੁਗਤ	هرجوگت
ਹਰਜੋਗ	هرجوگ
ਹਰਜੋਧ	هرجودھ
ਹਰਜ੍ਯੋਤ	هرجیوت
ਹਰਤਿਰਥ	هرتیرتھ
ਹਰਤੇਜ੍ਪਾਲ	هرتیجپال
ਹਰਦਯਾਲ	هردیال
ਹਰਦਾਸ	هرداس
ਹਰਦਿਪਾ	هردیپا
ਹਰਦੀਪ	هردیپ
ਹਰਧਨ	هردھن
ਹਰਨਾਮ	هرنام
ਹਰਨਾਰਾਯਣ	هرناراین
ਹਰਨਿਤ	هرنیت
ਹਰਨੀਰ੍ਮਲ	هرنیرمل
ਹਰਨੀਹਲ	هرنیهل
ਹਰਪਰ੍ਸਨ੍ਨ	هرپرسنن
ਹਰਪਾਲ	هرپال
ਹਰਪ੍ਰੇਮ੍ਜੀਤ	هرپریمجیت
ਹਰਬਿਂਦਰ	هربیندر
ਹਰਬਿਰ	هربیر
ਹਰਭਗਤ	هربھگت
ਹਰਮਨਾਦ	هرمناد
ਹਰਮਾਂਨ੍ਦੇਰ	هرمانندیر
ਹਰਮੀਤ	هرمیت
ਹਰਮੀਲਨ	هرمیلن
ਹਰਮੂਰਤ	هرمورت
ਹਰਰਾਈ	هررااِ
ਹਰਰੂਪ	هرروپ
ਹਰਵਂਤ	هرونت
ਹਰਵਿਨ	هروین
ਹਰਸ਼ਰਣ	هرسرن
ਹਰਸਿਤਾਲ	هرسیتال
ਹਰਸੀਮ੍ਰਣ	هرسیمرن
ਹਰਸੀਮ੍ਰਨ੍ਜੋਤ	هرسیمرنجوت
ਹਰਸੀਮ੍ਰਿਤ	هرسیمریت
ਹਰਸੁਖ	هرسوکھ
ਹਰਾਨੂਪ	هرانوپ
ਹਰਾਮ੍ਰੀਤ	هرامریت
ਹਰਿਕੀਰ੍ਤਨ	هریکیرتن
ਹਰਿਦਰ੍ਸ਼ਨ	هریدرسن
ਹਰਿਨਾਰਾਯਣ	هریناراین
ਹਰਿਪ੍ਰੀਤ	هریپریت
ਹਰੀਅਮ੍ਰਿਤ	هریامریت
ਹਰੀਸਰੂਪ	هریسروپ
ਹਰੀਸੀਮਾਂਰਣ	هریسیمانرن
ਹਰ੍ਕਾਰਾਨ੍ਜੀਤ	هرکارانجیت
ਹਰ੍ਕੀਰਨ੍ਜੀਤ	هرکیرنجیت
ਹਰ੍ਕੀਰਪਾਲ	هرکیرپال
ਹਰ੍ਜਸ	هرجس
ਹਰ੍ਤੇਇਜ	هرتیاِج
ਹਰ੍ਨੀਝ	هرنیجھ
ਹਰ੍ਬਂਸ	هربنس
ਹਰ੍ਮਾਂਨਜਿਤ	هرماننجیت
ਹਰ੍ਮਾਂਨਪਾਲ	هرماننپال
ਹਰ੍ਮੀਨ੍ਦੇਰ	هرمیندیر
ਹਰ੍ਮੇਂਦ੍ਰ	هرمیندر
ਹਰ੍ਸ਼ਰ੍ਧਾ	هرسردھا
ਹਰ੍ਸ਼ਵਰ੍ਧਨ	هرسوردھن
ਹਰ੍ਸ਼ਾਗੁਨ	هرساگون
ਹਰ੍ਸਿਰਤ	هرسیرت
ਹਸਨ	هسن
ਹਾਰਭਾਗ	هاربھاگ
ਹਿਤੀਨਦੇਰ	هیتیندیر
ਹਿਤੇਨਦੇਰ	هیتیندیر
ਹਿਮ੍ਮਤ	هیممت
ਹਿਰੀਸ਼	هیریس
ਹੁਅਲੀਨਾ	هوالینا
ਹੁਕੁਮਪਰਿਤ	هوکومپریت
ਹੂਜਓਏ	هوجاوے
ਹੇਤ	هیت
ਹੇਤਬੀਰ	هیتبیر
ਹੇਮੀਨਦੇਰ	هیمیندیر
ਹੇਯ੍ਮਾਂਨ੍ਪ੍ਰਿਤ	هییماننپریت
ਹੇਰਹੋ	هیرهو
